muni;ano;pop;pop_masc;pop_fem;sex_ratio;pop_urb;pop_rural;grau_urb;code_muni
Adamantina;2019;33891;16333;17558;93.02;32622;1269;96.26;3500105
Adamantina;2020;33894;16326;17568;92.93;32668;1226;96.38;3500105
Adamantina;2021;33869;16310;17559;92.89;32684;1185;96.5;3500105
Adolfo;2019;3458;1715;1743;98.39;3194;264;92.37;3500204
Adolfo;2020;3447;1707;1740;98.1;3189;258;92.52;3500204
Adolfo;2021;3436;1699;1737;97.81;3184;252;92.67;3500204
Aguaí;2019;35261;17721;17540;101.03;32451;2810;92.03;3500303
Aguaí;2020;35608;17889;17719;100.96;32833;2775;92.21;3500303
Aguaí;2021;35885;18021;17864;100.88;33151;2734;92.38;3500303
Águas da Prata;2019;7777;3822;3955;96.64;7150;627;91.94;3500402
Águas da Prata;2020;7797;3830;3967;96.55;7188;609;92.19;3500402
Águas da Prata;2021;7807;3834;3973;96.5;7215;592;92.42;3500402
Águas de Lindóia;2019;18268;8897;9371;94.94;18104;164;99.1;3500501
Águas de Lindóia;2020;18374;8944;9430;94.85;18209;165;99.1;3500501
Águas de Lindóia;2021;18438;8972;9466;94.78;18272;166;99.1;3500501
Águas de Santa Bárbara;2019;5899;2890;3009;96.05;4577;1322;77.59;3500550
Águas de Santa Bárbara;2020;5931;2903;3028;95.87;4611;1320;77.74;3500550
Águas de Santa Bárbara;2021;5957;2912;3045;95.63;4642;1315;77.93;3500550
Águas de São Pedro;2019;3082;1446;1636;88.39;3082;;100;3500600
Águas de São Pedro;2020;3122;1466;1656;88.53;3122;;100;3500600
Águas de São Pedro;2021;3144;1479;1665;88.83;3144;;100;3500600
Agudos;2019;35980;17746;18234;97.32;34642;1338;96.28;3500709
Agudos;2020;36134;17816;18318;97.26;34815;1319;96.35;3500709
Agudos;2021;36255;17869;18386;97.19;34955;1300;96.41;3500709
Alambari;2019;5689;2842;2847;99.82;4622;1067;81.24;3500758
Alambari;2020;5779;2885;2894;99.69;4729;1050;81.83;3500758
Alambari;2021;5856;2921;2935;99.52;4826;1030;82.41;3500758
Alfredo Marcondes;2019;3924;1999;1925;103.84;3531;393;89.98;3500808
Alfredo Marcondes;2020;3927;2001;1926;103.89;3554;373;90.5;3500808
Alfredo Marcondes;2021;3924;1999;1925;103.84;3571;353;91;3500808
Altair;2019;4015;2134;1881;113.45;3376;639;84.08;3500907
Altair;2020;4036;2142;1894;113.09;3413;623;84.56;3500907
Altair;2021;4052;2148;1904;112.82;3445;607;85.02;3500907
Altinópolis;2019;15555;7741;7814;99.07;14217;1338;91.4;3501004
Altinópolis;2020;15553;7735;7818;98.94;14272;1281;91.76;3501004
Altinópolis;2021;15547;7727;7820;98.81;14321;1226;92.11;3501004
Alto Alegre;2019;4027;2058;1969;104.52;3400;627;84.43;3501103
Alto Alegre;2020;4017;2052;1965;104.43;3412;605;84.94;3501103
Alto Alegre;2021;4006;2045;1961;104.28;3423;583;85.45;3501103
Alumínio;2019;17859;8971;8888;100.93;14978;2881;83.87;3501152
Alumínio;2020;17972;9023;8949;100.83;15073;2899;83.87;3501152
Alumínio;2021;18069;9067;9002;100.72;15155;2914;83.87;3501152
Álvares Florence;2019;3647;1848;1799;102.72;2663;984;73.02;3501202
Álvares Florence;2020;3621;1832;1789;102.4;2663;958;73.54;3501202
Álvares Florence;2021;3596;1818;1778;102.25;2663;933;74.05;3501202
Álvares Machado;2019;23751;11674;12077;96.66;21658;2093;91.19;3501301
Álvares Machado;2020;23789;11684;12105;96.52;21720;2069;91.3;3501301
Álvares Machado;2021;23828;11696;12132;96.41;21782;2046;91.41;3501301
Álvaro de Carvalho;2019;5003;3123;1880;166.12;3353;1650;67.02;3501400
Álvaro de Carvalho;2020;5044;3142;1902;165.19;3400;1644;67.41;3501400
Álvaro de Carvalho;2021;5079;3159;1920;164.53;3443;1636;67.79;3501400
Alvinlândia;2019;3160;1558;1602;97.25;2908;252;92.03;3501509
Alvinlândia;2020;3176;1566;1610;97.27;2929;247;92.22;3501509
Alvinlândia;2021;3190;1573;1617;97.28;2947;243;92.38;3501509
Americana;2019;231361;113156;118205;95.73;230280;1081;99.53;3501608
Americana;2020;233458;114164;119294;95.7;232367;1091;99.53;3501608
Americana;2021;235075;114935;120140;95.67;233977;1098;99.53;3501608
Américo Brasiliense;2019;39678;19835;19843;99.96;39378;300;99.24;3501707
Américo Brasiliense;2020;40243;20106;20137;99.85;39938;305;99.24;3501707
Américo Brasiliense;2021;40676;20312;20364;99.74;40368;308;99.24;3501707
Américo de Campos;2019;5735;2866;2869;99.9;5007;728;87.31;3501806
Américo de Campos;2020;5736;2865;2871;99.79;5025;711;87.6;3501806
Américo de Campos;2021;5730;2861;2869;99.72;5036;694;87.89;3501806
Amparo;2019;69291;34030;35261;96.51;57992;11299;83.69;3501905
Amparo;2020;69639;34189;35450;96.44;58620;11019;84.18;3501905
Amparo;2021;69861;34288;35573;96.39;59136;10725;84.65;3501905
Analândia;2019;4798;2450;2348;104.34;4003;795;83.43;3502002
Analândia;2020;4850;2475;2375;104.21;4065;785;83.81;3502002
Analândia;2021;4895;2497;2398;104.13;4122;773;84.21;3502002
Andradina;2019;55998;27423;28575;95.97;52755;3243;94.21;3502101
Andradina;2020;56054;27443;28611;95.92;52856;3198;94.29;3502101
Andradina;2021;56087;27456;28631;95.9;52935;3152;94.38;3502101
Angatuba;2019;24269;12195;12074;101;18089;6180;74.54;3502200
Angatuba;2020;24501;12302;12199;100.84;18333;6168;74.83;3502200
Angatuba;2021;24697;12392;12305;100.71;18550;6147;75.11;3502200
Anhembi;2019;6568;3348;3220;103.98;5154;1414;78.47;3502309
Anhembi;2020;6672;3398;3274;103.79;5256;1416;78.78;3502309
Anhembi;2021;6755;3437;3318;103.59;5342;1413;79.08;3502309
Anhumas;2019;3942;1961;1981;98.99;3439;503;87.24;3502408
Anhumas;2020;3963;1971;1992;98.95;3477;486;87.74;3502408
Anhumas;2021;3983;1981;2002;98.95;3513;470;88.2;3502408
Aparecida;2019;35640;17158;18482;92.84;35122;518;98.55;3502507
Aparecida;2020;35709;17187;18522;92.79;35190;519;98.55;3502507
Aparecida;2021;35744;17199;18545;92.74;35224;520;98.55;3502507
Aparecida d'Oeste;2019;4162;2017;2145;94.03;3599;563;86.47;3502606
Aparecida d'Oeste;2020;4132;2001;2131;93.9;3589;543;86.86;3502606
Aparecida d'Oeste;2021;4105;1987;2118;93.81;3581;524;87.24;3502606
Apiaí;2019;24674;12304;12370;99.47;19813;4861;80.3;3502705
Apiaí;2020;24666;12298;12368;99.43;19995;4671;81.06;3502705
Apiaí;2021;24711;12318;12393;99.39;20214;4497;81.8;3502705
Aramina;2019;5465;2727;2738;99.6;5253;212;96.12;3503000
Aramina;2020;5496;2741;2755;99.49;5293;203;96.31;3503000
Aramina;2021;5515;2749;2766;99.39;5320;195;96.46;3503000
Arandu;2019;6159;3097;3062;101.14;5043;1116;81.88;3503109
Arandu;2020;6165;3099;3066;101.08;5087;1078;82.51;3503109
Arandu;2021;6168;3099;3069;100.98;5127;1041;83.12;3503109
Arapeí;2019;2472;1236;1236;100;1914;558;77.43;3503158
Arapeí;2020;2471;1234;1237;99.76;1920;551;77.7;3503158
Arapeí;2021;2469;1232;1237;99.6;1924;545;77.93;3503158
Araraquara;2019;225997;109032;116965;93.22;219572;6425;97.16;3503208
Araraquara;2020;227618;109815;117803;93.22;221147;6471;97.16;3503208
Araraquara;2021;228792;110380;118412;93.22;222288;6504;97.16;3503208
Araras;2019;129861;63820;66041;96.64;123563;6298;95.15;3503307
Araras;2020;131057;64375;66682;96.54;124772;6285;95.2;3503307
Araras;2021;131931;64773;67158;96.45;125675;6256;95.26;3503307
Araçariguama;2019;20598;10424;10174;102.46;20598;;100;3502754
Araçariguama;2020;20980;10611;10369;102.33;20980;;100;3502754
Araçariguama;2021;21289;10761;10528;102.21;21289;;100;3502754
Araçatuba;2019;189674;90997;98677;92.22;186016;3658;98.07;3502804
Araçatuba;2020;190469;91360;99109;92.18;186796;3673;98.07;3502804
Araçatuba;2021;190921;91563;99358;92.15;187239;3682;98.07;3502804
Araçoiaba da Serra;2019;31878;15771;16107;97.91;21911;9967;68.73;3502903
Araçoiaba da Serra;2020;32390;16012;16378;97.77;22263;10127;68.73;3502903
Araçoiaba da Serra;2021;32846;16228;16618;97.65;22577;10269;68.74;3502903
ArcoÍris;2019;1824;911;913;99.78;1157;667;63.43;3503356
ArcoÍris;2020;1816;906;910;99.56;1165;651;64.15;3503356
ArcoÍris;2021;1806;900;906;99.34;1171;635;64.84;3503356
Arealva;2019;8162;4109;4053;101.38;6809;1353;83.42;3503406
Arealva;2020;8196;4121;4075;101.13;6875;1321;83.88;3503406
Arealva;2021;8223;4130;4093;100.9;6934;1289;84.32;3503406
Areias;2019;3825;1892;1933;97.88;2564;1261;67.03;3503505
Areias;2020;3843;1901;1942;97.89;2577;1266;67.06;3503505
Areias;2021;3860;1909;1951;97.85;2588;1272;67.05;3503505
Areiópolis;2019;10822;5543;5279;105;9996;826;92.37;3503604
Areiópolis;2020;10857;5558;5299;104.89;10062;795;92.68;3503604
Areiópolis;2021;10900;5577;5323;104.77;10134;766;92.97;3503604
Ariranha;2019;9245;4680;4565;102.52;8755;490;94.7;3503703
Ariranha;2020;9320;4714;4606;102.34;8826;494;94.7;3503703
Ariranha;2021;9378;4740;4638;102.2;8881;497;94.7;3503703
Artur Nogueira;2019;51846;25756;26090;98.72;46942;4904;90.54;3503802
Artur Nogueira;2020;52609;26120;26489;98.61;47632;4977;90.54;3503802
Artur Nogueira;2021;53224;26412;26812;98.51;48189;5035;90.54;3503802
Arujá;2019;88232;43502;44730;97.25;84948;3284;96.28;3503901
Arujá;2020;89744;44246;45498;97.25;86429;3315;96.31;3503901
Arujá;2021;90958;44839;46119;97.22;87623;3335;96.33;3503901
Aspásia;2019;1769;884;885;99.89;1316;453;74.39;3503950
Aspásia;2020;1765;882;883;99.89;1322;443;74.9;3503950
Aspásia;2021;1760;879;881;99.77;1327;433;75.4;3503950
Assis;2019;100781;49069;51712;94.89;96382;4399;95.64;3504008
Assis;2020;101381;49365;52016;94.9;96956;4425;95.64;3504008
Assis;2021;101825;49587;52238;94.93;97380;4445;95.63;3504008
Atibaia;2019;138351;67836;70515;96.2;129281;9070;93.44;3504107
Atibaia;2020;139606;68437;71169;96.16;130756;8850;93.66;3504107
Atibaia;2021;140589;68910;71679;96.14;131968;8621;93.87;3504107
Auriflama;2019;14450;7175;7275;98.63;13470;980;93.22;3504206
Auriflama;2020;14471;7181;7290;98.5;13517;954;93.41;3504206
Auriflama;2021;14478;7180;7298;98.38;13550;928;93.59;3504206
Avaí;2019;5255;2629;2626;100.11;3529;1726;67.16;3504305
Avaí;2020;5288;2643;2645;99.92;3551;1737;67.15;3504305
Avaí;2021;5314;2654;2660;99.77;3568;1746;67.14;3504305
Avanhandava;2019;12030;6595;5435;121.34;10172;1858;84.56;3504404
Avanhandava;2020;12114;6637;5477;121.18;10243;1871;84.56;3504404
Avanhandava;2021;12188;6673;5515;121;10305;1883;84.55;3504404
Avaré;2019;87102;43125;43977;98.06;84026;3076;96.47;3504503
Avaré;2020;87538;43336;44202;98.04;84509;3029;96.54;3504503
Avaré;2021;87854;43484;44370;98;84875;2979;96.61;3504503
Bady Bassitt;2019;16182;8036;8146;98.65;15194;988;93.89;3504602
Bady Bassitt;2020;16329;8109;8220;98.65;15333;996;93.9;3504602
Bady Bassitt;2021;16441;8164;8277;98.63;15440;1001;93.91;3504602
Balbinos;2019;3702;2978;724;411.33;1191;2511;32.17;3504701
Balbinos;2020;3704;2978;726;410.19;1191;2513;32.15;3504701
Balbinos;2021;3707;2980;727;409.9;1193;2514;32.18;3504701
Bálsamo;2019;8493;4137;4356;94.97;7911;582;93.15;3504800
Bálsamo;2020;8524;4150;4374;94.88;7948;576;93.24;3504800
Bálsamo;2021;8542;4157;4385;94.8;7971;571;93.32;3504800
Bananal;2019;10605;5229;5376;97.27;8911;1694;84.03;3504909
Bananal;2020;10651;5251;5400;97.24;8994;1657;84.44;3504909
Bananal;2021;10691;5270;5421;97.21;9071;1620;84.85;3504909
Barão de Antonina;2019;3356;1698;1658;102.41;2131;1225;63.5;3505005
Barão de Antonina;2020;3383;1710;1673;102.21;2156;1227;63.73;3505005
Barão de Antonina;2021;3407;1721;1686;102.08;2180;1227;63.99;3505005
Barbosa;2019;7212;3616;3596;100.56;6162;1050;85.44;3505104
Barbosa;2020;7284;3651;3633;100.5;6230;1054;85.53;3505104
Barbosa;2021;7345;3681;3664;100.46;6290;1055;85.64;3505104
Bariri;2019;33765;16837;16928;99.46;32503;1262;96.26;3505203
Bariri;2020;33993;16944;17049;99.38;32762;1231;96.38;3505203
Bariri;2021;34180;17033;17147;99.34;32979;1201;96.49;3505203
Barra Bonita;2019;34943;17033;17910;95.1;34291;652;98.13;3505302
Barra Bonita;2020;34914;17011;17903;95.02;34268;646;98.15;3505302
Barra Bonita;2021;34864;16979;17885;94.93;34224;640;98.16;3505302
Barra do Chapéu;2019;5499;2873;2626;109.41;1619;3880;29.44;3505351
Barra do Chapéu;2020;5530;2886;2644;109.15;1628;3902;29.44;3505351
Barra do Chapéu;2021;5561;2899;2662;108.9;1637;3924;29.44;3505351
Barra do Turvo;2019;7681;3973;3708;107.15;3545;4136;46.15;3505401
Barra do Turvo;2020;7687;3971;3716;106.86;3591;4096;46.72;3505401
Barra do Turvo;2021;7709;3977;3732;106.56;3645;4064;47.28;3505401
Barretos;2019;117509;56819;60690;93.62;113929;3580;96.95;3505500
Barretos;2020;118048;57086;60962;93.64;114452;3596;96.95;3505500
Barretos;2021;118419;57275;61144;93.67;114812;3607;96.95;3505500
Barrinha;2019;31954;16004;15950;100.34;31600;354;98.89;3505609
Barrinha;2020;32338;16190;16148;100.26;31979;359;98.89;3505609
Barrinha;2021;32658;16344;16314;100.18;32296;362;98.89;3505609
Barueri;2019;262081;127502;134579;94.74;262081;;100;3505708
Barueri;2020;264390;128627;135763;94.74;264390;;100;3505708
Barueri;2021;266236;129518;136718;94.73;266236;;100;3505708
Bastos;2019;20293;9917;10376;95.58;17949;2344;88.45;3505807
Bastos;2020;20301;9916;10385;95.48;18001;2300;88.67;3505807
Bastos;2021;20296;9910;10386;95.42;18040;2256;88.88;3505807
Batatais;2019;59868;29360;30508;96.24;52945;6923;88.44;3505906
Batatais;2020;60222;29529;30693;96.21;53258;6964;88.44;3505906
Batatais;2021;60502;29661;30841;96.17;53505;6997;88.44;3505906
Bauru;2019;362348;175562;186786;93.99;356287;6061;98.33;3506003
Bauru;2020;364225;176473;187752;93.99;358133;6092;98.33;3506003
Bauru;2021;365523;177109;188414;94;359409;6114;98.33;3506003
Bebedouro;2019;74264;36086;38178;94.52;71366;2898;96.1;3506102
Bebedouro;2020;74155;36025;38130;94.48;71307;2848;96.16;3506102
Bebedouro;2021;73969;35926;38043;94.44;71170;2799;96.22;3506102
Bento de Abreu;2019;2919;1477;1442;102.43;2783;136;95.34;3506201
Bento de Abreu;2020;2945;1489;1456;102.27;2815;130;95.59;3506201
Bento de Abreu;2021;2966;1499;1467;102.18;2842;124;95.82;3506201
Bernardino de Campos;2019;10784;5242;5542;94.59;9850;934;91.34;3506300
Bernardino de Campos;2020;10787;5243;5544;94.57;9869;918;91.49;3506300
Bernardino de Campos;2021;10793;5246;5547;94.57;9891;902;91.64;3506300
Bertioga;2019;61684;30633;31051;98.65;61072;612;99.01;3506359
Bertioga;2020;63290;31408;31882;98.51;62695;595;99.06;3506359
Bertioga;2021;64526;32002;32524;98.4;63952;574;99.11;3506359
Bilac;2019;7745;3816;3929;97.12;7291;454;94.14;3506409
Bilac;2020;7816;3849;3967;97.03;7373;443;94.33;3506409
Bilac;2021;7855;3866;3989;96.92;7424;431;94.51;3506409
Birigui;2019;120138;58407;61731;94.62;116931;3207;97.33;3506508
Birigui;2020;121329;58965;62364;94.55;118125;3204;97.36;3506508
Birigui;2021;122161;59350;62811;94.49;118968;3193;97.39;3506508
Biritiba Mirim;2019;31952;16041;15911;100.82;27830;4122;87.1;3506607
Biritiba Mirim;2020;32338;16227;16111;100.72;28210;4128;87.23;3506607
Biritiba Mirim;2021;32683;16394;16289;100.64;28554;4129;87.37;3506607
Boa Esperança do Sul;2019;14489;7243;7246;99.96;13286;1203;91.7;3506706
Boa Esperança do Sul;2020;14582;7283;7299;99.78;13403;1179;91.91;3506706
Boa Esperança do Sul;2021;14658;7316;7342;99.65;13504;1154;92.13;3506706
Bocaina;2019;12011;5963;6048;98.59;11211;800;93.34;3506805
Bocaina;2020;12135;6022;6113;98.51;11341;794;93.46;3506805
Bocaina;2021;12243;6072;6171;98.4;11456;787;93.57;3506805
Bofete;2019;10932;5503;5429;101.36;6970;3962;63.76;3506904
Bofete;2020;11076;5568;5508;101.09;7062;4014;63.76;3506904
Bofete;2021;11194;5622;5572;100.9;7137;4057;63.76;3506904
Boituva;2019;56455;28267;28188;100.28;53106;3349;94.07;3507001
Boituva;2020;57292;28670;28622;100.17;53893;3399;94.07;3507001
Boituva;2021;57987;29004;28983;100.07;54547;3440;94.07;3507001
Bom Jesus dos Perdões;2019;23841;11911;11930;99.84;21649;2192;90.81;3507100
Bom Jesus dos Perdões;2020;24291;12127;12164;99.7;22118;2173;91.05;3507100
Bom Jesus dos Perdões;2021;24625;12287;12338;99.59;22482;2143;91.3;3507100
Bom Sucesso de Itararé;2019;3829;1930;1899;101.63;2838;991;74.12;3507159
Bom Sucesso de Itararé;2020;3861;1944;1917;101.41;2885;976;74.72;3507159
Bom Sucesso de Itararé;2021;3894;1959;1935;101.24;2934;960;75.35;3507159
Borá;2019;811;422;389;108.48;632;179;77.93;3507209
Borá;2020;812;422;390;108.21;632;180;77.83;3507209
Borá;2021;811;421;390;107.95;632;179;77.93;3507209
Boracéia;2019;4710;2393;2317;103.28;4290;420;91.08;3507308
Boracéia;2020;4759;2417;2342;103.2;4342;417;91.24;3507308
Boracéia;2021;4798;2436;2362;103.13;4384;414;91.37;3507308
Borborema;2019;15253;7676;7577;101.31;14298;955;93.74;3507407
Borborema;2020;15323;7707;7616;101.19;14405;918;94.01;3507407
Borborema;2021;15370;7727;7643;101.1;14487;883;94.26;3507407
Borebi;2019;2552;1260;1292;97.52;2364;188;92.63;3507456
Borebi;2020;2579;1272;1307;97.32;2400;179;93.06;3507456
Borebi;2021;2602;1283;1319;97.27;2431;171;93.43;3507456
Botucatu;2019;139856;67945;71911;94.48;135121;4735;96.61;3507506
Botucatu;2020;141135;68579;72556;94.52;136396;4739;96.64;3507506
Botucatu;2021;142092;69051;73041;94.54;137360;4732;96.67;3507506
Bragança Paulista;2019;162402;79651;82751;96.25;159258;3144;98.06;3507605
Bragança Paulista;2020;163980;80417;83563;96.24;160871;3109;98.1;3507605
Bragança Paulista;2021;165241;81024;84217;96.21;162162;3079;98.14;3507605
Braúna;2019;5501;2764;2737;100.99;5081;420;92.37;3507704
Braúna;2020;5552;2786;2766;100.72;5150;402;92.76;3507704
Braúna;2021;5593;2805;2788;100.61;5208;385;93.12;3507704
Brejo Alegre;2019;2749;1400;1349;103.78;2352;397;85.56;3507753
Brejo Alegre;2020;2768;1408;1360;103.53;2378;390;85.91;3507753
Brejo Alegre;2021;2780;1412;1368;103.22;2398;382;86.26;3507753
Brodowski;2019;23684;11665;12019;97.05;23372;312;98.68;3507803
Brodowski;2020;23943;11785;12158;96.93;23647;296;98.76;3507803
Brodowski;2021;24132;11872;12260;96.84;23851;281;98.84;3507803
Brotas;2019;23635;11715;11920;98.28;20531;3104;86.87;3507902
Brotas;2020;23850;11820;12030;98.25;20735;3115;86.94;3507902
Brotas;2021;24039;11912;12127;98.23;20917;3122;87.01;3507902
Buri;2019;19553;9924;9629;103.06;16304;3249;83.38;3508009
Buri;2020;19678;9979;9699;102.89;16462;3216;83.66;3508009
Buri;2021;19819;10043;9776;102.73;16633;3186;83.92;3508009
Buritama;2019;16486;8214;8272;99.3;15795;691;95.81;3508108
Buritama;2020;16596;8263;8333;99.16;15922;674;95.94;3508108
Buritama;2021;16673;8297;8376;99.06;16016;657;96.06;3508108
Buritizal;2019;4282;2179;2103;103.61;3581;701;83.63;3508207
Buritizal;2020;4307;2191;2116;103.54;3611;696;83.84;3508207
Buritizal;2021;4323;2198;2125;103.44;3634;689;84.06;3508207
Cabrália Paulista;2019;4311;2180;2131;102.3;3759;552;87.2;3508306
Cabrália Paulista;2020;4308;2177;2131;102.16;3760;548;87.28;3508306
Cabrália Paulista;2021;4306;2174;2132;101.97;3761;545;87.34;3508306
Cabreúva;2019;48630;24453;24177;101.14;43375;5255;89.19;3508405
Cabreúva;2020;49430;24837;24593;100.99;44288;5142;89.6;3508405
Cabreúva;2021;50112;25163;24949;100.86;45093;5019;89.98;3508405
Cachoeira Paulista;2019;32027;15642;16385;95.47;26681;5346;83.31;3508603
Cachoeira Paulista;2020;32231;15736;16495;95.4;26907;5324;83.48;3508603
Cachoeira Paulista;2021;32381;15804;16577;95.34;27088;5293;83.65;3508603
Caconde;2019;18820;9360;9460;98.94;13447;5373;71.45;3508702
Caconde;2020;18854;9370;9484;98.8;13537;5317;71.8;3508702
Caconde;2021;18893;9384;9509;98.69;13630;5263;72.14;3508702
Cafelândia;2019;17183;8455;8728;96.87;15426;1757;89.77;3508801
Cafelândia;2020;17244;8485;8759;96.87;15529;1715;90.05;3508801
Cafelândia;2021;17286;8506;8780;96.88;15613;1673;90.32;3508801
Caiabu;2019;4102;2103;1999;105.2;3490;612;85.08;3508900
Caiabu;2020;4103;2103;2000;105.15;3506;597;85.45;3508900
Caiabu;2021;4104;2103;2001;105.1;3521;583;85.79;3508900
Caieiras;2019;99177;48571;50606;95.98;97399;1778;98.21;3509007
Caieiras;2020;100612;49282;51330;96.01;98864;1748;98.26;3509007
Caieiras;2021;101748;49841;51907;96.02;100032;1716;98.31;3509007
Caiuá;2019;5543;2868;2675;107.21;2123;3420;38.3;3509106
Caiuá;2020;5600;2893;2707;106.87;2145;3455;38.3;3509106
Caiuá;2021;5642;2911;2731;106.59;2161;3481;38.3;3509106
Cajamar;2019;76256;37972;38284;99.19;75328;928;98.78;3509205
Cajamar;2020;77627;38646;38981;99.14;76714;913;98.82;3509205
Cajamar;2021;78786;39214;39572;99.1;77888;898;98.86;3509205
Cajati;2019;28894;14546;14348;101.38;21395;7499;74.05;3509254
Cajati;2020;28992;14590;14402;101.31;21499;7493;74.15;3509254
Cajati;2021;29116;14647;14469;101.23;21623;7493;74.27;3509254
Cajobi;2019;10076;5128;4948;103.64;9555;521;94.83;3509304
Cajobi;2020;10105;5137;4968;103.4;9594;511;94.94;3509304
Cajobi;2021;10124;5142;4982;103.21;9623;501;95.05;3509304
Cajuru;2019;25434;12675;12759;99.34;22722;2712;89.34;3509403
Cajuru;2020;25663;12784;12879;99.26;22937;2726;89.38;3509403
Cajuru;2021;25850;12874;12976;99.21;23114;2736;89.42;3509403
Campina do Monte Alegre;2019;5788;2922;2866;101.95;5081;707;87.79;3509452
Campina do Monte Alegre;2020;5812;2929;2883;101.6;5120;692;88.09;3509452
Campina do Monte Alegre;2021;5832;2936;2896;101.38;5155;677;88.39;3509452
Campinas;2019;1167192;563198;603994;93.25;1147122;20070;98.28;3509502
Campinas;2020;1175501;567233;608268;93.25;1155288;20213;98.28;3509502
Campinas;2021;1181555;570167;611388;93.26;1161238;20317;98.28;3509502
Campo Limpo Paulista;2019;81979;40196;41783;96.2;81979;;100;3509601
Campo Limpo Paulista;2020;82842;40611;42231;96.16;82842;;100;3509601
Campo Limpo Paulista;2021;83530;40939;42591;96.12;83530;;100;3509601
Campos do Jordão;2019;49892;24275;25617;94.76;49581;311;99.38;3509700
Campos do Jordão;2020;50118;24371;25747;94.66;49805;313;99.38;3509700
Campos do Jordão;2021;50307;24452;25855;94.57;49993;314;99.38;3509700
Campos Novos Paulista;2019;4789;2451;2338;104.83;3937;852;82.21;3509809
Campos Novos Paulista;2020;4817;2464;2353;104.72;3981;836;82.64;3509809
Campos Novos Paulista;2021;4841;2475;2366;104.61;4022;819;83.08;3509809
Cananéia;2019;12315;6136;6179;99.3;10674;1641;86.67;3509908
Cananéia;2020;12341;6144;6197;99.14;10710;1631;86.78;3509908
Cananéia;2021;12379;6159;6220;99.02;10756;1623;86.89;3509908
Canas;2019;4996;2511;2485;101.05;4794;202;95.96;3509957
Canas;2020;5064;2543;2521;100.87;4870;194;96.17;3509957
Canas;2021;5120;2570;2550;100.78;4933;187;96.35;3509957
Cândido Mota;2019;30008;14690;15318;95.9;28509;1499;95;3510005
Cândido Mota;2020;30019;14693;15326;95.87;28537;1482;95.06;3510005
Cândido Mota;2021;30010;14685;15325;95.82;28544;1466;95.11;3510005
Cândido Rodrigues;2019;2674;1307;1367;95.61;2275;399;85.08;3510104
Cândido Rodrigues;2020;2674;1306;1368;95.47;2286;388;85.49;3510104
Cândido Rodrigues;2021;2672;1304;1368;95.32;2295;377;85.89;3510104
Canitar;2019;4926;2485;2441;101.8;4703;223;95.47;3510153
Canitar;2020;4991;2516;2475;101.66;4766;225;95.49;3510153
Canitar;2021;5051;2545;2506;101.56;4823;228;95.49;3510153
Capão Bonito;2019;46361;23033;23328;98.74;39277;7084;84.72;3510203
Capão Bonito;2020;46418;23054;23364;98.67;39459;6959;85.01;3510203
Capão Bonito;2021;46521;23098;23423;98.61;39678;6843;85.29;3510203
Capela do Alto;2019;20225;10362;9863;105.06;17471;2754;86.38;3510302
Capela do Alto;2020;20542;10517;10025;104.91;17817;2725;86.73;3510302
Capela do Alto;2021;20828;10656;10172;104.76;18136;2692;87.08;3510302
Capivari;2019;53662;26804;26858;99.8;52283;1379;97.43;3510401
Capivari;2020;54231;27079;27152;99.73;52908;1323;97.56;3510401
Capivari;2021;54686;27296;27390;99.66;53413;1273;97.67;3510401
Caraguatatuba;2019;114648;56316;58332;96.54;110345;4303;96.25;3510500
Caraguatatuba;2020;116106;56984;59122;96.38;111793;4313;96.29;3510500
Caraguatatuba;2021;117090;57431;59659;96.27;112783;4307;96.32;3510500
Carapicuíba;2019;392297;190529;201768;94.43;392297;;100;3510609
Carapicuíba;2020;394598;191655;202943;94.44;394598;;100;3510609
Carapicuíba;2021;396447;192549;203898;94.43;396447;;100;3510609
Cardoso;2019;11730;5745;5985;95.99;10779;951;91.89;3510708
Cardoso;2020;11721;5736;5985;95.84;10781;940;91.98;3510708
Cardoso;2021;11712;5729;5983;95.75;10782;930;92.06;3510708
Casa Branca;2019;29348;15399;13949;110.4;24280;5068;82.73;3510807
Casa Branca;2020;29462;15444;14018;110.17;24404;5058;82.83;3510807
Casa Branca;2021;29549;15476;14073;109.97;24506;5043;82.93;3510807
Cássia dos Coqueiros;2019;2506;1273;1233;103.24;1905;601;76.02;3510906
Cássia dos Coqueiros;2020;2495;1266;1229;103.01;1916;579;76.79;3510906
Cássia dos Coqueiros;2021;2486;1261;1225;102.94;1928;558;77.55;3510906
Castilho;2019;20458;10128;10330;98.04;15439;5019;75.47;3511003
Castilho;2020;20728;10256;10472;97.94;15642;5086;75.46;3511003
Castilho;2021;20937;10355;10582;97.85;15800;5137;75.46;3511003
Catanduva;2019;116819;56687;60132;94.27;115881;938;99.2;3511102
Catanduva;2020;117206;56874;60332;94.27;116265;941;99.2;3511102
Catanduva;2021;117414;56972;60442;94.26;116471;943;99.2;3511102
Catiguá;2019;7492;3787;3705;102.21;6971;521;93.05;3511201
Catiguá;2020;7529;3802;3727;102.01;7010;519;93.11;3511201
Catiguá;2021;7555;3812;3743;101.84;7039;516;93.17;3511201
Caçapava;2019;90636;44769;45867;97.61;77552;13084;85.56;3508504
Caçapava;2020;91217;45040;46177;97.54;78049;13168;85.56;3508504
Caçapava;2021;91646;45234;46412;97.46;78416;13230;85.56;3508504
Cedral;2019;8754;4345;4409;98.55;7228;1526;82.57;3511300
Cedral;2020;8836;4384;4452;98.47;7326;1510;82.91;3511300
Cedral;2021;8895;4412;4483;98.42;7404;1491;83.24;3511300
Cerqueira César;2019;19046;9377;9669;96.98;17521;1525;91.99;3511409
Cerqueira César;2020;19213;9455;9758;96.89;17718;1495;92.22;3511409
Cerqueira César;2021;19350;9519;9831;96.83;17886;1464;92.43;3511409
Cerquilho;2019;45783;22637;23146;97.8;43414;2369;94.83;3511508
Cerquilho;2020;46411;22942;23469;97.75;44009;2402;94.82;3511508
Cerquilho;2021;46932;23194;23738;97.71;44503;2429;94.82;3511508
Cesário Lange;2019;17099;8832;8267;106.83;11545;5554;67.52;3511607
Cesário Lange;2020;17248;8905;8343;106.74;11645;5603;67.52;3511607
Cesário Lange;2021;17360;8959;8401;106.64;11721;5639;67.52;3511607
Charqueada;2019;16751;8487;8264;102.7;15312;1439;91.41;3511706
Charqueada;2020;16933;8574;8359;102.57;15491;1442;91.48;3511706
Charqueada;2021;17075;8642;8433;102.48;15633;1442;91.55;3511706
Chavantes;2019;12212;6052;6160;98.25;11498;714;94.15;3557204
Chavantes;2020;12223;6055;6168;98.17;11525;698;94.29;3557204
Chavantes;2021;12229;6055;6174;98.07;11546;683;94.41;3557204
Clementina;2019;8205;4234;3971;106.62;7942;263;96.79;3511904
Clementina;2020;8324;4293;4031;106.5;8066;258;96.9;3511904
Clementina;2021;8413;4337;4076;106.4;8160;253;96.99;3511904
Colina;2019;17585;8658;8927;96.99;16740;845;95.19;3512001
Colina;2020;17603;8660;8943;96.84;16781;822;95.33;3512001
Colina;2021;17606;8655;8951;96.69;16806;800;95.46;3512001
Colômbia;2019;6042;3054;2988;102.21;4522;1520;74.84;3512100
Colômbia;2020;6046;3052;2994;101.94;4541;1505;75.11;3512100
Colômbia;2021;6048;3050;2998;101.73;4559;1489;75.38;3512100
Conchal;2019;27081;13622;13459;101.21;26146;935;96.55;3512209
Conchal;2020;27284;13716;13568;101.09;26382;902;96.69;3512209
Conchal;2021;27445;13790;13655;100.99;26574;871;96.83;3512209
Conchas;2019;17050;8515;8535;99.77;14489;2561;84.98;3512308
Conchas;2020;17134;8552;8582;99.65;14628;2506;85.37;3512308
Conchas;2021;17203;8583;8620;99.57;14752;2451;85.75;3512308
Cordeirópolis;2019;24041;12060;11981;100.66;21594;2447;89.82;3512407
Cordeirópolis;2020;24356;12216;12140;100.63;21876;2480;89.82;3512407
Cordeirópolis;2021;24615;12342;12273;100.56;22109;2506;89.82;3512407
Coroados;2019;5864;2910;2954;98.51;5003;861;85.32;3512506
Coroados;2020;5926;2940;2986;98.46;5081;845;85.74;3512506
Coroados;2021;5971;2961;3010;98.37;5144;827;86.15;3512506
Coronel Macedo;2019;4854;2470;2384;103.61;3957;897;81.52;3512605
Coronel Macedo;2020;4843;2463;2380;103.49;3969;874;81.95;3512605
Coronel Macedo;2021;4839;2459;2380;103.32;3986;853;82.37;3512605
Corumbataí;2019;3953;1989;1964;101.27;2437;1516;61.65;3512704
Corumbataí;2020;3962;1991;1971;101.01;2475;1487;62.47;3512704
Corumbataí;2021;3969;1992;1977;100.76;2512;1457;63.29;3512704
Cosmópolis;2019;70050;34819;35231;98.83;65057;4993;92.87;3512803
Cosmópolis;2020;71282;35411;35871;98.72;66201;5081;92.87;3512803
Cosmópolis;2021;72215;35858;36357;98.63;67068;5147;92.87;3512803
Cosmorama;2019;7017;3504;3513;99.74;5330;1687;75.96;3512902
Cosmorama;2020;6997;3489;3508;99.46;5364;1633;76.66;3512902
Cosmorama;2021;6976;3475;3501;99.26;5396;1580;77.35;3512902
Cotia;2019;242763;118779;123984;95.8;242763;;100;3513009
Cotia;2020;247424;121053;126371;95.79;247424;;100;3513009
Cotia;2021;251382;122984;128398;95.78;251382;;100;3513009
Cravinhos;2019;34161;17031;17130;99.42;33630;531;98.45;3513108
Cravinhos;2020;34428;17154;17274;99.31;33919;509;98.52;3513108
Cravinhos;2021;34637;17249;17388;99.2;34150;487;98.59;3513108
Cristais Paulista;2019;8344;4228;4116;102.72;6850;1494;82.09;3513207
Cristais Paulista;2020;8425;4265;4160;102.52;6987;1438;82.93;3513207
Cristais Paulista;2021;8494;4297;4197;102.38;7113;1381;83.74;3513207
Cruzália;2019;2130;1030;1100;93.64;1508;622;70.8;3513306
Cruzália;2020;2117;1023;1094;93.51;1508;609;71.23;3513306
Cruzália;2021;2105;1017;1088;93.47;1509;596;71.69;3513306
Cruzeiro;2019;79656;38695;40961;94.47;77832;1824;97.71;3513405
Cruzeiro;2020;79927;38818;41109;94.43;78112;1815;97.73;3513405
Cruzeiro;2021;80128;38908;41220;94.39;78323;1805;97.75;3513405
Cubatão;2019;128108;63630;64478;98.68;128108;;100;3513504
Cubatão;2020;129145;64116;65029;98.6;129145;;100;3513504
Cubatão;2021;130025;64526;65499;98.51;130025;;100;3513504
Cunha;2019;21684;11000;10684;102.96;13461;8223;62.08;3513603
Cunha;2020;21681;10990;10691;102.8;13609;8072;62.77;3513603
Cunha;2021;21660;10973;10687;102.68;13744;7916;63.45;3513603
Descalvado;2019;32302;15877;16425;96.66;29858;2444;92.43;3513702
Descalvado;2020;32430;15933;16497;96.58;30064;2366;92.7;3513702
Descalvado;2021;32516;15969;16547;96.51;30226;2290;92.96;3513702
Diadema;2019;402813;194850;207963;93.69;402813;;100;3513801
Diadema;2020;404477;195649;208828;93.69;404477;;100;3513801
Diadema;2021;405596;196182;209414;93.68;405596;;100;3513801
Dirce Reis;2019;1715;869;846;102.72;1406;309;81.98;3513850
Dirce Reis;2020;1717;868;849;102.24;1417;300;82.53;3513850
Dirce Reis;2021;1715;866;849;102;1425;290;83.09;3513850
Divinolândia;2019;10913;5383;5530;97.34;8129;2784;74.49;3513900
Divinolândia;2020;10886;5364;5522;97.14;8192;2694;75.25;3513900
Divinolândia;2021;10865;5349;5516;96.97;8256;2609;75.99;3513900
Dobrada;2019;8806;4523;4283;105.6;8610;196;97.77;3514007
Dobrada;2020;8904;4569;4335;105.4;8705;199;97.77;3514007
Dobrada;2021;8985;4607;4378;105.23;8785;200;97.77;3514007
Dois Córregos;2019;26748;13368;13380;99.91;25859;889;96.68;3514106
Dois Córregos;2020;26972;13477;13495;99.87;26113;859;96.82;3514106
Dois Córregos;2021;27151;13562;13589;99.8;26321;830;96.94;3514106
Dolcinópolis;2019;2046;1059;987;107.29;1920;126;93.84;3514205
Dolcinópolis;2020;2040;1056;984;107.32;1915;125;93.87;3514205
Dolcinópolis;2021;2033;1051;982;107.03;1908;125;93.85;3514205
Dourado;2019;8494;4271;4223;101.14;7787;707;91.68;3514304
Dourado;2020;8482;4261;4221;100.95;7778;704;91.7;3514304
Dourado;2021;8466;4250;4216;100.81;7766;700;91.73;3514304
Dracena;2019;44844;22059;22785;96.81;41634;3210;92.84;3514403
Dracena;2020;44995;22124;22871;96.73;41798;3197;92.89;3514403
Dracena;2021;45088;22165;22923;96.69;41908;3180;92.95;3514403
Duartina;2019;12003;5806;6197;93.69;11044;959;92.01;3514502
Duartina;2020;11975;5788;6187;93.55;11044;931;92.23;3514502
Duartina;2021;11941;5768;6173;93.44;11037;904;92.43;3514502
Dumont;2019;9445;4720;4725;99.89;9258;187;98.02;3514601
Dumont;2020;9570;4779;4791;99.75;9392;178;98.14;3514601
Dumont;2021;9659;4820;4839;99.61;9490;169;98.25;3514601
Echaporã;2019;6226;3054;3172;96.28;5134;1092;82.46;3514700
Echaporã;2020;6217;3048;3169;96.18;5145;1072;82.76;3514700
Echaporã;2021;6208;3042;3166;96.08;5155;1053;83.04;3514700
Eldorado;2019;15154;7660;7494;102.22;7457;7697;49.21;3514809
Eldorado;2020;15236;7693;7543;101.99;7498;7738;49.21;3514809
Eldorado;2021;15331;7734;7597;101.8;7545;7786;49.21;3514809
Elias Fausto;2019;17197;8850;8347;106.03;14410;2787;83.79;3514908
Elias Fausto;2020;17346;8921;8425;105.89;14606;2740;84.2;3514908
Elias Fausto;2021;17459;8973;8486;105.74;14772;2687;84.61;3514908
Elisiário;2019;3464;1802;1662;108.42;3231;233;93.27;3514924
Elisiário;2020;3499;1817;1682;108.03;3267;232;93.37;3514924
Elisiário;2021;3518;1824;1694;107.67;3287;231;93.43;3514924
Embaúba;2019;2409;1247;1162;107.31;2131;278;88.46;3514957
Embaúba;2020;2409;1246;1163;107.14;2139;270;88.79;3514957
Embaúba;2021;2406;1244;1162;107.06;2143;263;89.07;3514957
Embu das Artes;2019;267771;130139;137632;94.56;267771;;100;3515004
Embu das Artes;2020;270790;131608;139182;94.56;270790;;100;3515004
Embu das Artes;2021;273266;132810;140456;94.56;273266;;100;3515004
EmbuGuaçu;2019;67521;33408;34113;97.93;65720;1801;97.33;3515103
EmbuGuaçu;2020;68053;33656;34397;97.85;66238;1815;97.33;3515103
EmbuGuaçu;2021;68565;33894;34671;97.76;66736;1829;97.33;3515103
Emilianópolis;2019;3065;1533;1532;100.07;2676;389;87.31;3515129
Emilianópolis;2020;3068;1534;1534;100;2692;376;87.74;3515129
Emilianópolis;2021;3069;1534;1535;99.93;2706;363;88.17;3515129
Engenheiro Coelho;2019;20077;10432;9645;108.16;15232;4845;75.87;3515152
Engenheiro Coelho;2020;20535;10661;9874;107.97;15639;4896;76.16;3515152
Engenheiro Coelho;2021;20884;10835;10049;107.82;15965;4919;76.45;3515152
Espírito Santo do Pinhal;2019;42517;20779;21738;95.59;38697;3820;91.02;3515186
Espírito Santo do Pinhal;2020;42573;20804;21769;95.57;38837;3736;91.22;3515186
Espírito Santo do Pinhal;2021;42639;20833;21806;95.54;38983;3656;91.43;3515186
Espírito Santo do Turvo;2019;4741;2369;2372;99.87;4055;686;85.53;3515194
Espírito Santo do Turvo;2020;4799;2395;2404;99.63;4105;694;85.54;3515194
Espírito Santo do Turvo;2021;4850;2418;2432;99.42;4148;702;85.53;3515194
Estiva Gerbi;2019;10977;5479;5498;99.65;8755;2222;79.76;3557303
Estiva Gerbi;2020;11079;5523;5556;99.41;8837;2242;79.76;3557303
Estiva Gerbi;2021;11156;5555;5601;99.18;8898;2258;79.76;3557303
Estrela d'Oeste;2019;8107;4064;4043;100.52;7044;1063;86.89;3515202
Estrela d'Oeste;2020;8094;4056;4038;100.45;7059;1035;87.21;3515202
Estrela d'Oeste;2021;8083;4048;4035;100.32;7075;1008;87.53;3515202
Estrela do Norte;2019;2663;1358;1305;104.06;2289;374;85.96;3515301
Estrela do Norte;2020;2665;1357;1308;103.75;2307;358;86.57;3515301
Estrela do Norte;2021;2668;1357;1311;103.51;2326;342;87.18;3515301
Euclides da Cunha Paulista;2019;9530;4754;4776;99.54;6143;3387;64.46;3515350
Euclides da Cunha Paulista;2020;9537;4753;4784;99.35;6155;3382;64.54;3515350
Euclides da Cunha Paulista;2021;9549;4756;4793;99.23;6170;3379;64.61;3515350
Fartura;2019;15608;7536;8072;93.36;12964;2644;83.06;3515400
Fartura;2020;15644;7550;8094;93.28;13045;2599;83.39;3515400
Fartura;2021;15679;7564;8115;93.21;13124;2555;83.7;3515400
Fernando Prestes;2019;5570;2717;2853;95.23;5017;553;90.07;3515608
Fernando Prestes;2020;5572;2716;2856;95.1;5043;529;90.51;3515608
Fernando Prestes;2021;5568;2712;2856;94.96;5062;506;90.91;3515608
Fernandópolis;2019;65999;32018;33981;94.22;63977;2022;96.94;3515509
Fernandópolis;2020;66112;32060;34052;94.15;64087;2025;96.94;3515509
Fernandópolis;2021;66131;32060;34071;94.1;64105;2026;96.94;3515509
Fernão;2019;1640;825;815;101.23;993;647;60.55;3515657
Fernão;2020;1649;828;821;100.85;1009;640;61.19;3515657
Fernão;2021;1656;830;826;100.48;1024;632;61.84;3515657
Ferraz de Vasconcelos;2019;190519;93045;97474;95.46;181970;8549;95.51;3515707
Ferraz de Vasconcelos;2020;193037;94280;98757;95.47;184375;8662;95.51;3515707
Ferraz de Vasconcelos;2021;195168;95326;99842;95.48;186411;8757;95.51;3515707
Flora Rica;2019;1601;794;807;98.39;1388;213;86.7;3515806
Flora Rica;2020;1589;787;802;98.13;1386;203;87.22;3515806
Flora Rica;2021;1575;780;795;98.11;1382;193;87.75;3515806
Floreal;2019;2870;1410;1460;96.58;2423;447;84.43;3515905
Floreal;2020;2856;1401;1455;96.29;2420;436;84.73;3515905
Floreal;2021;2842;1392;1450;96;2417;425;85.05;3515905
Flórida Paulista;2019;12184;6672;5512;121.04;9613;2571;78.9;3516002
Flórida Paulista;2020;12120;6637;5483;121.05;9563;2557;78.9;3516002
Flórida Paulista;2021;12060;6603;5457;121;9515;2545;78.9;3516002
Florínea;2019;2713;1313;1400;93.79;2478;235;91.34;3516101
Florínea;2020;2703;1307;1396;93.62;2475;228;91.56;3516101
Florínea;2021;2697;1303;1394;93.47;2475;222;91.77;3516101
Franca;2019;339925;166172;173753;95.64;333957;5968;98.24;3516200
Franca;2020;342125;167238;174887;95.63;336119;6006;98.24;3516200
Franca;2021;343801;168053;175748;95.62;337765;6036;98.24;3516200
Francisco Morato;2019;172283;85310;86973;98.09;171933;350;99.8;3516309
Francisco Morato;2020;174403;86341;88062;98.05;174048;355;99.8;3516309
Francisco Morato;2021;176346;87289;89057;98.01;175988;358;99.8;3516309
Franco da Rocha;2019;150151;76460;73691;103.76;138331;11820;92.13;3516408
Franco da Rocha;2020;152201;77456;74745;103.63;140219;11982;92.13;3516408
Franco da Rocha;2021;153903;78282;75621;103.52;141788;12115;92.13;3516408
Gabriel Monteiro;2019;2688;1348;1340;100.6;2377;311;88.43;3516507
Gabriel Monteiro;2020;2684;1344;1340;100.3;2386;298;88.9;3516507
Gabriel Monteiro;2021;2677;1340;1337;100.22;2391;286;89.32;3516507
Gália;2019;6596;3268;3328;98.2;5095;1501;77.24;3516606
Gália;2020;6563;3248;3315;97.98;5089;1474;77.54;3516606
Gália;2021;6537;3232;3305;97.79;5087;1450;77.82;3516606
Garça;2019;42540;20653;21887;94.36;39783;2757;93.52;3516705
Garça;2020;42483;20622;21861;94.33;39806;2677;93.7;3516705
Garça;2021;42385;20571;21814;94.3;39784;2601;93.86;3516705
Gastão Vidigal;2019;4716;2562;2154;118.94;4409;307;93.49;3516804
Gastão Vidigal;2020;4768;2588;2180;118.72;4473;295;93.81;3516804
Gastão Vidigal;2021;4811;2609;2202;118.48;4527;284;94.1;3516804
Gavião Peixoto;2019;4591;2354;2237;105.23;4071;520;88.67;3516853
Gavião Peixoto;2020;4610;2362;2248;105.07;4116;494;89.28;3516853
Gavião Peixoto;2021;4627;2369;2258;104.92;4158;469;89.86;3516853
General Salgado;2019;10655;5295;5360;98.79;9399;1256;88.21;3516903
General Salgado;2020;10648;5286;5362;98.58;9424;1224;88.5;3516903
General Salgado;2021;10632;5274;5358;98.43;9441;1191;88.8;3516903
Getulina;2019;10837;5883;4954;118.75;8792;2045;81.13;3517000
Getulina;2020;10847;5887;4960;118.69;8841;2006;81.51;3517000
Getulina;2021;10856;5890;4966;118.61;8888;1968;81.87;3517000
Glicério;2019;4732;2354;2378;98.99;3631;1101;76.73;3517109
Glicério;2020;4749;2361;2388;98.87;3659;1090;77.05;3517109
Glicério;2021;4762;2365;2397;98.66;3684;1078;77.36;3517109
Guaimbê;2019;5521;2730;2791;97.81;5016;505;90.85;3517307
Guaimbê;2020;5534;2735;2799;97.71;5045;489;91.16;3517307
Guaimbê;2021;5547;2740;2807;97.61;5074;473;91.47;3517307
Guaíra;2019;38913;19183;19730;97.23;37690;1223;96.86;3517406
Guaíra;2020;39061;19247;19814;97.14;37840;1221;96.87;3517406
Guaíra;2021;39154;19284;19870;97.05;37936;1218;96.89;3517406
Guaiçara;2019;11822;5921;5901;100.34;10991;831;92.97;3517208
Guaiçara;2020;11947;5981;5966;100.25;11131;816;93.17;3517208
Guaiçara;2021;12045;6028;6017;100.18;11245;800;93.36;3517208
Guapiara;2019;17758;8980;8778;102.3;7456;10302;41.99;3517604
Guapiara;2020;17775;8983;8792;102.17;7499;10276;42.19;3517604
Guapiara;2021;17832;9006;8826;102.04;7559;10273;42.39;3517604
Guapiaçu;2019;20569;10347;10222;101.22;18650;1919;90.67;3517505
Guapiaçu;2020;20848;10482;10366;101.12;18942;1906;90.86;3517505
Guapiaçu;2021;21060;10583;10477;101.01;19172;1888;91.04;3517505
Guará;2019;20722;10287;10435;98.58;20218;504;97.57;3517703
Guará;2020;20824;10335;10489;98.53;20329;495;97.62;3517703
Guará;2021;20907;10374;10533;98.49;20420;487;97.67;3517703
Guaraci;2019;10879;5518;5361;102.93;10080;799;92.66;3517901
Guaraci;2020;10978;5565;5413;102.81;10201;777;92.92;3517901
Guaraci;2021;11050;5599;5451;102.72;10295;755;93.17;3517901
Guarani d'Oeste;2019;1927;941;986;95.44;1720;207;89.26;3518008
Guarani d'Oeste;2020;1922;939;983;95.52;1718;204;89.39;3518008
Guarani d'Oeste;2021;1917;937;980;95.61;1715;202;89.46;3518008
Guarantã;2019;6468;3240;3228;100.37;5846;622;90.38;3518107
Guarantã;2020;6477;3243;3234;100.28;5882;595;90.81;3518107
Guarantã;2021;6485;3246;3239;100.22;5916;569;91.23;3518107
Guararapes;2019;31949;15669;16280;96.25;29997;1952;93.89;3518206
Guararapes;2020;32076;15724;16352;96.16;30158;1918;94.02;3518206
Guararapes;2021;32160;15761;16399;96.11;30277;1883;94.14;3518206
Guararema;2019;29058;14519;14539;99.86;25006;4052;86.06;3518305
Guararema;2020;29429;14694;14735;99.72;25325;4104;86.05;3518305
Guararema;2021;29736;14839;14897;99.61;25589;4147;86.05;3518305
Guaratinguetá;2019;117760;56638;61122;92.66;112297;5463;95.36;3518404
Guaratinguetá;2020;118345;56915;61430;92.65;112868;5477;95.37;3518404
Guaratinguetá;2021;118741;57102;61639;92.64;113258;5483;95.38;3518404
Guaraçaí;2019;8418;4146;4272;97.05;6890;1528;81.85;3517802
Guaraçaí;2020;8412;4140;4272;96.91;6910;1502;82.14;3517802
Guaraçaí;2021;8400;4132;4268;96.81;6926;1474;82.45;3517802
Guareí;2019;15631;9394;6237;150.62;9029;6602;57.76;3518503
Guareí;2020;15750;9448;6302;149.92;9097;6653;57.76;3518503
Guareí;2021;15844;9489;6355;149.32;9152;6692;57.76;3518503
Guariba;2019;38681;19404;19277;100.66;38054;627;98.38;3518602
Guariba;2020;39021;19563;19458;100.54;38406;615;98.42;3518602
Guariba;2021;39285;19684;19601;100.42;38682;603;98.47;3518602
Guarujá;2019;313756;152849;160907;94.99;313696;60;99.98;3518701
Guarujá;2020;316405;154134;162271;94.99;316344;61;99.98;3518701
Guarujá;2021;318774;155283;163491;94.98;318713;61;99.98;3518701
Guarulhos;2019;1338452;652095;686357;95.01;1338452;;100;3518800
Guarulhos;2020;1351275;658363;692912;95.01;1351275;;100;3518800
Guarulhos;2021;1361862;663550;698312;95.02;1361862;;100;3518800
Guatapará;2019;7392;3766;3626;103.86;5897;1495;79.78;3518859
Guatapará;2020;7440;3787;3653;103.67;5982;1458;80.4;3518859
Guatapará;2021;7482;3805;3677;103.48;6062;1420;81.02;3518859
Guzolândia;2019;5072;2565;2507;102.31;4499;573;88.7;3518909
Guzolândia;2020;5107;2579;2528;102.02;4550;557;89.09;3518909
Guzolândia;2021;5134;2590;2544;101.81;4592;542;89.44;3518909
Herculândia;2019;9204;4594;4610;99.65;8603;601;93.47;3519006
Herculândia;2020;9260;4621;4639;99.61;8671;589;93.64;3519006
Herculândia;2021;9310;4646;4664;99.61;8733;577;93.8;3519006
Holambra;2019;14194;7179;7015;102.34;11896;2298;83.81;3519055
Holambra;2020;14493;7329;7164;102.3;12287;2206;84.78;3519055
Holambra;2021;14711;7437;7274;102.24;12606;2105;85.69;3519055
Hortolândia;2019;226426;113838;112588;101.11;226426;;100;3519071
Hortolândia;2020;230268;115703;114565;100.99;230268;;100;3519071
Hortolândia;2021;233548;117291;116257;100.89;233548;;100;3519071
Iacanga;2019;11182;5723;5459;104.84;9899;1283;88.53;3519105
Iacanga;2020;11306;5782;5524;104.67;10025;1281;88.67;3519105
Iacanga;2021;11410;5832;5578;104.55;10134;1276;88.82;3519105
Iacri;2019;6288;3177;3111;102.12;5282;1006;84;3519204
Iacri;2020;6272;3168;3104;102.06;5299;973;84.49;3519204
Iacri;2021;6255;3159;3096;102.03;5314;941;84.96;3519204
Iaras;2019;6839;4408;2431;181.32;3043;3796;44.49;3519253
Iaras;2020;6894;4434;2460;180.24;3067;3827;44.49;3519253
Iaras;2021;6943;4458;2485;179.4;3089;3854;44.49;3519253
Ibaté;2019;34345;17523;16822;104.17;33156;1189;96.54;3519303
Ibaté;2020;34738;17709;17029;103.99;33550;1188;96.58;3519303
Ibaté;2021;35044;17852;17192;103.84;33859;1185;96.62;3519303
Ibirá;2019;11949;5911;6038;97.9;11158;791;93.38;3519402
Ibirá;2020;12059;5963;6096;97.82;11269;790;93.45;3519402
Ibirá;2021;12132;5997;6135;97.75;11344;788;93.5;3519402
Ibirarema;2019;7430;3722;3708;100.38;6971;459;93.82;3519501
Ibirarema;2020;7509;3759;3750;100.24;7054;455;93.94;3519501
Ibirarema;2021;7570;3788;3782;100.16;7119;451;94.04;3519501
Ibitinga;2019;58003;28523;29480;96.75;56100;1903;96.72;3519600
Ibitinga;2020;58501;28760;29741;96.7;56607;1894;96.76;3519600
Ibitinga;2021;58860;28929;29931;96.65;56977;1883;96.8;3519600
Ibiúna;2019;75908;38288;37620;101.78;27862;48046;36.7;3519709
Ibiúna;2020;76430;38520;37910;101.61;28199;48231;36.9;3519709
Ibiúna;2021;76867;38714;38153;101.47;28507;48360;37.09;3519709
Icém;2019;7977;4048;3929;103.03;6908;1069;86.6;3519808
Icém;2020;8032;4075;3957;102.98;6963;1069;86.69;3519808
Icém;2021;8077;4098;3979;102.99;7008;1069;86.76;3519808
Iepê;2019;7890;3875;4015;96.51;7300;590;92.52;3519907
Iepê;2020;7921;3887;4034;96.36;7354;567;92.84;3519907
Iepê;2021;7943;3896;4047;96.27;7397;546;93.13;3519907
Igarapava;2019;29316;14482;14834;97.63;27956;1360;95.36;3520103
Igarapava;2020;29456;14549;14907;97.6;28119;1337;95.46;3520103
Igarapava;2021;29560;14599;14961;97.58;28246;1314;95.55;3520103
Igaratá;2019;9264;4709;4555;103.38;7880;1384;85.06;3520202
Igaratá;2020;9312;4729;4583;103.19;7971;1341;85.6;3520202
Igaratá;2021;9354;4746;4608;102.99;8055;1299;86.11;3520202
Igaraçu do Tietê;2019;24055;11942;12113;98.59;23917;138;99.43;3520004
Igaraçu do Tietê;2020;24135;11976;12159;98.49;23997;138;99.43;3520004
Igaraçu do Tietê;2021;24206;12005;12201;98.39;24067;139;99.43;3520004
Iguape;2019;29388;14607;14781;98.82;25730;3658;87.55;3520301
Iguape;2020;29465;14632;14833;98.64;25834;3631;87.68;3520301
Iguape;2021;29555;14668;14887;98.53;25946;3609;87.79;3520301
Ilha Comprida;2019;10163;4953;5210;95.07;10163;;100;3520426
Ilha Comprida;2020;10296;5009;5287;94.74;10296;;100;3520426
Ilha Comprida;2021;10410;5058;5352;94.51;10410;;100;3520426
Ilha Solteira;2019;25695;12411;13284;93.43;24112;1583;93.84;3520442
Ilha Solteira;2020;25748;12426;13322;93.27;24162;1586;93.84;3520442
Ilha Solteira;2021;25754;12421;13333;93.16;24167;1587;93.84;3520442
Ilhabela;2019;32968;16624;16344;101.71;32741;227;99.31;3520400
Ilhabela;2020;33470;16864;16606;101.55;33240;230;99.31;3520400
Ilhabela;2021;33821;17028;16793;101.4;33588;233;99.31;3520400
Indaiatuba;2019;239391;118547;120844;98.1;236984;2407;98.99;3520509
Indaiatuba;2020;242868;120227;122641;98.03;240426;2442;98.99;3520509
Indaiatuba;2021;245366;121414;123952;97.95;242899;2467;98.99;3520509
Indiana;2019;4780;2391;2389;100.08;4202;578;87.91;3520608
Indiana;2020;4775;2388;2387;100.04;4209;566;88.15;3520608
Indiana;2021;4771;2386;2385;100.04;4217;554;88.39;3520608
Indiaporã;2019;3857;1871;1986;94.21;3483;374;90.3;3520707
Indiaporã;2020;3854;1867;1987;93.96;3491;363;90.58;3520707
Indiaporã;2021;3847;1862;1985;93.8;3495;352;90.85;3520707
Inúbia Paulista;2019;3867;1927;1940;99.33;3494;373;90.35;3520806
Inúbia Paulista;2020;3892;1938;1954;99.18;3527;365;90.62;3520806
Inúbia Paulista;2021;3913;1947;1966;99.03;3557;356;90.9;3520806
Ipaussu;2019;14420;7238;7182;100.78;13544;876;93.93;3520905
Ipaussu;2020;14506;7278;7228;100.69;13644;862;94.06;3520905
Ipaussu;2021;14578;7312;7266;100.63;13729;849;94.18;3520905
Iperó;2019;33769;17892;15877;112.69;20838;12931;61.71;3521002
Iperó;2020;34352;18176;16176;112.36;21197;13155;61.71;3521002
Iperó;2021;34800;18393;16407;112.1;21474;13326;61.71;3521002
Ipeúna;2019;7406;3798;3608;105.27;6683;723;90.24;3521101
Ipeúna;2020;7571;3879;3692;105.07;6860;711;90.61;3521101
Ipeúna;2021;7711;3947;3764;104.86;7015;696;90.97;3521101
Ipiguá;2019;5157;2596;2561;101.37;3314;1843;64.26;3521150
Ipiguá;2020;5231;2631;2600;101.19;3383;1848;64.67;3521150
Ipiguá;2021;5286;2657;2629;101.07;3441;1845;65.1;3521150
Iporanga;2019;4393;2201;2192;100.41;2843;1550;64.72;3521200
Iporanga;2020;4407;2206;2201;100.23;2894;1513;65.67;3521200
Iporanga;2021;4424;2213;2211;100.09;2945;1479;66.57;3521200
Ipuã;2019;15693;7943;7750;102.49;15181;512;96.74;3521309
Ipuã;2020;15861;8022;7839;102.33;15355;506;96.81;3521309
Ipuã;2021;16001;8087;7914;102.19;15502;499;96.88;3521309
Iracemápolis;2019;23316;11626;11690;99.45;22904;412;98.23;3521408
Iracemápolis;2020;23654;11787;11867;99.33;23238;416;98.24;3521408
Iracemápolis;2021;23907;11907;12000;99.23;23489;418;98.25;3521408
Irapuã;2019;7690;3990;3700;107.84;7078;612;92.04;3521507
Irapuã;2020;7734;4010;3724;107.68;7132;602;92.22;3521507
Irapuã;2021;7767;4024;3743;107.51;7176;591;92.39;3521507
Irapuru;2019;7376;4280;3096;138.24;5215;2161;70.7;3521606
Irapuru;2020;7334;4255;3079;138.19;5185;2149;70.7;3521606
Irapuru;2021;7295;4234;3061;138.32;5158;2137;70.71;3521606
Itaberá;2019;17627;8848;8779;100.79;13260;4367;75.23;3521705
Itaberá;2020;17614;8836;8778;100.66;13379;4235;75.96;3521705
Itaberá;2021;17615;8831;8784;100.54;13505;4110;76.67;3521705
Itaí;2019;26254;13809;12445;110.96;20616;5638;78.53;3521804
Itaí;2020;26507;13928;12579;110.72;20814;5693;78.52;3521804
Itaí;2021;26725;14030;12695;110.52;20985;5740;78.52;3521804
Itajobi;2019;14615;7315;7300;100.21;12789;1826;87.51;3521903
Itajobi;2020;14614;7308;7306;100.03;12840;1774;87.86;3521903
Itajobi;2021;14602;7295;7307;99.84;12878;1724;88.19;3521903
Itaju;2019;3615;1873;1742;107.52;2901;714;80.25;3522000
Itaju;2020;3654;1891;1763;107.26;2959;695;80.98;3522000
Itaju;2021;3688;1906;1782;106.96;3012;676;81.67;3522000
Itanhaém;2019;97569;47005;50564;92.96;96823;746;99.24;3522109
Itanhaém;2020;98757;47554;51203;92.87;98018;739;99.25;3522109
Itanhaém;2021;99751;48020;51731;92.83;99021;730;99.27;3522109
Itaoca;2019;3186;1653;1533;107.83;1737;1449;54.52;3522158
Itaoca;2020;3186;1652;1534;107.69;1737;1449;54.52;3522158
Itaoca;2021;3187;1652;1535;107.62;1738;1449;54.53;3522158
Itapecerica da Serra;2019;167916;83751;84165;99.51;166524;1392;99.17;3522208
Itapecerica da Serra;2020;169619;84582;85037;99.46;168213;1406;99.17;3522208
Itapecerica da Serra;2021;171123;85313;85810;99.42;169705;1418;99.17;3522208
Itapetininga;2019;158553;78949;79604;99.18;145723;12830;91.91;3522307
Itapetininga;2020;160150;79719;80431;99.11;147379;12771;92.03;3522307
Itapetininga;2021;161509;80372;81137;99.06;148816;12693;92.14;3522307
Itapeva;2019;91265;44960;46305;97.1;82551;8714;90.45;3522406
Itapeva;2020;91693;45170;46523;97.09;83413;8280;90.97;3522406
Itapeva;2021;92123;45384;46739;97.1;84255;7868;91.46;3522406
Itapevi;2019;233816;114994;118822;96.78;233816;;100;3522505
Itapevi;2020;237714;116910;120804;96.78;237714;;100;3522505
Itapevi;2021;241150;118599;122551;96.78;241150;;100;3522505
Itapira;2019;71266;35134;36132;97.24;66743;4523;93.65;3522604
Itapira;2020;71500;35231;36269;97.14;67027;4473;93.74;3522604
Itapira;2021;71609;35266;36343;97.04;67192;4417;93.83;3522604
Itapirapuã Paulista;2019;4144;2109;2035;103.64;2117;2027;51.09;3522653
Itapirapuã Paulista;2020;4180;2124;2056;103.31;2146;2034;51.34;3522653
Itapirapuã Paulista;2021;4214;2139;2075;103.08;2175;2039;51.61;3522653
Itápolis;2019;41405;20434;20971;97.44;38737;2668;93.56;3522703
Itápolis;2020;41548;20493;21055;97.33;38966;2582;93.79;3522703
Itápolis;2021;41648;20534;21114;97.25;39150;2498;94;3522703
Itaporanga;2019;14671;7295;7376;98.9;11865;2806;80.87;3522802
Itaporanga;2020;14688;7300;7388;98.81;11952;2736;81.37;3522802
Itaporanga;2021;14710;7307;7403;98.7;12043;2667;81.87;3522802
Itapuí;2019;13622;6831;6791;100.59;13203;419;96.92;3522901
Itapuí;2020;13779;6904;6875;100.42;13369;410;97.02;3522901
Itapuí;2021;13913;6966;6947;100.27;13513;400;97.12;3522901
Itapura;2019;4860;2485;2375;104.63;3884;976;79.92;3523008
Itapura;2020;4916;2510;2406;104.32;3929;987;79.92;3523008
Itapura;2021;4965;2532;2433;104.07;3968;997;79.92;3523008
Itaquaquecetuba;2019;365490;179781;185709;96.81;365490;;100;3523107
Itaquaquecetuba;2020;370589;182254;188335;96.77;370589;;100;3523107
Itaquaquecetuba;2021;374997;184390;190607;96.74;374997;;100;3523107
Itararé;2019;48889;23951;24938;96.04;45322;3567;92.7;3523206
Itararé;2020;49018;24010;25008;96.01;45460;3558;92.74;3523206
Itararé;2021;49149;24071;25078;95.98;45600;3549;92.78;3523206
Itariri;2019;17087;8550;8537;100.15;12076;5011;70.67;3523305
Itariri;2020;17274;8637;8637;100;12323;4951;71.34;3523305
Itariri;2021;17442;8716;8726;99.89;12556;4886;71.99;3523305
Itatiba;2019;116365;57275;59090;96.93;101099;15266;86.88;3523404
Itatiba;2020;117916;58013;59903;96.84;102739;15177;87.13;3523404
Itatiba;2021;119084;58564;60520;96.77;104047;15037;87.37;3523404
Itatinga;2019;20290;10317;9973;103.45;18905;1385;93.17;3523503
Itatinga;2020;20550;10443;10107;103.32;19190;1360;93.38;3523503
Itatinga;2021;20752;10540;10212;103.21;19420;1332;93.58;3523503
Itirapina;2019;17000;9882;7118;138.83;15690;1310;92.29;3523602
Itirapina;2020;17162;9962;7200;138.36;15873;1289;92.49;3523602
Itirapina;2021;17284;10021;7263;137.97;16020;1264;92.69;3523602
Itirapuã;2019;6242;3153;3089;102.07;5375;867;86.11;3523701
Itirapuã;2020;6279;3169;3110;101.9;5425;854;86.4;3523701
Itirapuã;2021;6311;3182;3129;101.69;5470;841;86.67;3523701
Itobi;2019;7603;3893;3710;104.93;7129;474;93.77;3523800
Itobi;2020;7609;3891;3718;104.65;7157;452;94.06;3523800
Itobi;2021;7608;3887;3721;104.46;7176;432;94.32;3523800
Itu;2019;168252;82929;85323;97.19;159774;8478;94.96;3523909
Itu;2020;169772;83649;86123;97.13;161437;8335;95.09;3523909
Itu;2021;170938;84191;86747;97.05;162761;8177;95.22;3523909
Itupeva;2019;57704;29102;28602;101.75;53661;4043;92.99;3524006
Itupeva;2020;59159;29812;29347;101.58;55279;3880;93.44;3524006
Itupeva;2021;60255;30344;29911;101.45;56552;3703;93.85;3524006
Ituverava;2019;40106;19510;20596;94.73;37758;2348;94.15;3524105
Ituverava;2020;40246;19573;20673;94.68;37890;2356;94.15;3524105
Ituverava;2021;40333;19613;20720;94.66;37972;2361;94.15;3524105
Jaborandi;2019;6670;3350;3320;100.9;6326;344;94.84;3524204
Jaborandi;2020;6677;3351;3326;100.75;6340;337;94.95;3524204
Jaborandi;2021;6681;3351;3330;100.63;6351;330;95.06;3524204
Jaboticabal;2019;73994;35895;38099;94.22;72653;1341;98.19;3524303
Jaboticabal;2020;74221;35999;38222;94.18;72946;1275;98.28;3524303
Jaboticabal;2021;74352;36056;38296;94.15;73140;1212;98.37;3524303
Jacareí;2019;226355;110323;116032;95.08;223229;3126;98.62;3524402
Jacareí;2020;227945;111079;116866;95.05;224797;3148;98.62;3524402
Jacareí;2021;229163;111654;117509;95.02;225998;3165;98.62;3524402
Jaci;2019;6839;3462;3377;102.52;6231;608;91.11;3524501
Jaci;2020;6969;3524;3445;102.29;6371;598;91.42;3524501
Jaci;2021;7052;3563;3489;102.12;6467;585;91.7;3524501
Jacupiranga;2019;17208;8718;8490;102.69;9369;7839;54.45;3524600
Jacupiranga;2020;17222;8719;8503;102.54;9377;7845;54.45;3524600
Jacupiranga;2021;17237;8721;8516;102.41;9385;7852;54.45;3524600
Jaguariúna;2019;53925;26617;27308;97.47;52922;1003;98.14;3524709
Jaguariúna;2020;54848;27057;27791;97.36;53844;1004;98.17;3524709
Jaguariúna;2021;55477;27353;28124;97.26;54474;1003;98.19;3524709
Jales;2019;47237;22958;24279;94.56;44451;2786;94.1;3524808
Jales;2020;47254;22954;24300;94.46;44467;2787;94.1;3524808
Jales;2021;47242;22940;24302;94.4;44455;2787;94.1;3524808
Jambeiro;2019;6138;3134;3004;104.33;2939;3199;47.88;3524907
Jambeiro;2020;6214;3168;3046;104.01;2975;3239;47.88;3524907
Jambeiro;2021;6272;3193;3079;103.7;3003;3269;47.88;3524907
Jandira;2019;122053;59712;62341;95.78;122053;;100;3525003
Jandira;2020;123603;60463;63140;95.76;123603;;100;3525003
Jandira;2021;124940;61104;63836;95.72;124940;;100;3525003
Jardinópolis;2019;42402;21216;21186;100.14;41528;874;97.94;3525102
Jardinópolis;2020;42893;21450;21443;100.03;42070;823;98.08;3525102
Jardinópolis;2021;43258;21622;21636;99.94;42485;773;98.21;3525102
Jarinu;2019;29225;14567;14658;99.38;24970;4255;85.44;3525201
Jarinu;2020;29820;14848;14972;99.17;25692;4128;86.16;3525201
Jarinu;2021;30330;15088;15242;98.99;26338;3992;86.84;3525201
Jaú;2019;145940;71224;74716;95.33;142291;3649;97.5;3525300
Jaú;2020;147505;71960;75545;95.25;143891;3614;97.55;3525300
Jaú;2021;148613;72479;76134;95.2;145043;3570;97.6;3525300
Jeriquara;2019;3143;1605;1538;104.36;2723;420;86.64;3525409
Jeriquara;2020;3141;1603;1538;104.23;2733;408;87.01;3525409
Jeriquara;2021;3141;1602;1539;104.09;2746;395;87.42;3525409
Joanópolis;2019;12583;6299;6284;100.24;12583;;100;3525508
Joanópolis;2020;12666;6336;6330;100.09;12666;;100;3525508
Joanópolis;2021;12720;6359;6361;99.97;12720;;100;3525508
João Ramalho;2019;4361;2211;2150;102.84;3869;492;88.72;3525607
João Ramalho;2020;4384;2223;2161;102.87;3903;481;89.03;3525607
João Ramalho;2021;4404;2234;2170;102.95;3933;471;89.31;3525607
José Bonifácio;2019;35663;17722;17941;98.78;32885;2778;92.21;3525706
José Bonifácio;2020;35981;17873;18108;98.7;33223;2758;92.33;3525706
José Bonifácio;2021;36229;17991;18238;98.65;33493;2736;92.45;3525706
Júlio Mesquita;2019;4617;2246;2371;94.73;4407;210;95.45;3525805
Júlio Mesquita;2020;4640;2255;2385;94.55;4430;210;95.47;3525805
Júlio Mesquita;2021;4658;2263;2395;94.49;4447;211;95.47;3525805
Jumirim;2019;3258;1672;1586;105.42;2119;1139;65.04;3525854
Jumirim;2020;3306;1695;1611;105.21;2175;1131;65.79;3525854
Jumirim;2021;3343;1714;1629;105.22;2224;1119;66.53;3525854
Jundiaí;2019;403769;197114;206655;95.38;391578;12191;96.98;3525904
Jundiaí;2020;407016;198688;208328;95.37;395118;11898;97.08;3525904
Jundiaí;2021;409439;199858;209581;95.36;397835;11604;97.17;3525904
Junqueirópolis;2019;19932;10452;9480;110.25;16903;3029;84.8;3526001
Junqueirópolis;2020;20065;10511;9554;110.02;17068;2997;85.06;3526001
Junqueirópolis;2021;20174;10562;9612;109.88;17213;2961;85.32;3526001
Juquiá;2019;18844;9427;9417;100.11;12278;6566;65.16;3526100
Juquiá;2020;18828;9408;9420;99.87;12310;6518;65.38;3526100
Juquiá;2021;18856;9413;9443;99.68;12370;6486;65.6;3526100
Juquitiba;2019;30220;15176;15044;100.88;25721;4499;85.11;3526209
Juquitiba;2020;30401;15255;15146;100.72;26087;4314;85.81;3526209
Juquitiba;2021;30579;15334;15245;100.58;26445;4134;86.48;3526209
Lagoinha;2019;4819;2430;2389;101.72;3393;1426;70.41;3526308
Lagoinha;2020;4819;2426;2393;101.38;3421;1398;70.99;3526308
Lagoinha;2021;4821;2425;2396;101.21;3450;1371;71.56;3526308
Laranjal Paulista;2019;27580;13567;14013;96.82;24951;2629;90.47;3526407
Laranjal Paulista;2020;27834;13687;14147;96.75;25207;2627;90.56;3526407
Laranjal Paulista;2021;28042;13786;14256;96.7;25423;2619;90.66;3526407
Lavínia;2019;8524;6011;2513;239.2;4161;4363;48.82;3526506
Lavínia;2020;8500;5997;2503;239.59;4148;4352;48.8;3526506
Lavínia;2021;8476;5984;2492;240.13;4137;4339;48.81;3526506
Lavrinhas;2019;7109;3557;3552;100.14;6674;435;93.88;3526605
Lavrinhas;2020;7167;3584;3583;100.03;6741;426;94.06;3526605
Lavrinhas;2021;7218;3607;3611;99.89;6802;416;94.24;3526605
Leme;2019;100069;49944;50125;99.64;98272;1797;98.2;3526704
Leme;2020;100975;50369;50606;99.53;99174;1801;98.22;3526704
Leme;2021;101693;50701;50992;99.43;99889;1804;98.23;3526704
Lençóis Paulista;2019;65870;32569;33301;97.8;64691;1179;98.21;3526803
Lençóis Paulista;2020;66343;32787;33556;97.71;65168;1175;98.23;3526803
Lençóis Paulista;2021;66695;32947;33748;97.63;65524;1171;98.24;3526803
Limeira;2019;294392;144333;150059;96.18;287379;7013;97.62;3526902
Limeira;2020;296300;145230;151070;96.13;289378;6922;97.66;3526902
Limeira;2021;297662;145861;151801;96.09;290836;6826;97.71;3526902
Lindóia;2019;7632;3760;3872;97.11;7632;;100;3527009
Lindóia;2020;7722;3802;3920;96.99;7722;;100;3527009
Lindóia;2021;7789;3833;3956;96.89;7789;;100;3527009
Lins;2019;74763;36268;38495;94.21;73889;874;98.83;3527108
Lins;2020;75087;36425;38662;94.21;74209;878;98.83;3527108
Lins;2021;75318;36535;38783;94.2;74438;880;98.83;3527108
Lorena;2019;86238;41647;44591;93.4;84105;2133;97.53;3527207
Lorena;2020;86639;41841;44798;93.4;84522;2117;97.56;3527207
Lorena;2021;86952;41994;44958;93.41;84852;2100;97.58;3527207
Lourdes;2019;2179;1131;1048;107.92;1860;319;85.36;3527256
Lourdes;2020;2182;1132;1050;107.81;1870;312;85.7;3527256
Lourdes;2021;2183;1132;1051;107.71;1878;305;86.03;3527256
Louveira;2019;47236;23820;23416;101.73;46075;1161;97.54;3527306
Louveira;2020;48268;24328;23940;101.62;47122;1146;97.63;3527306
Louveira;2021;48965;24666;24299;101.51;47838;1127;97.7;3527306
Lucélia;2019;20912;10984;9928;110.64;18270;2642;87.37;3527405
Lucélia;2020;21019;11029;9990;110.4;18381;2638;87.45;3527405
Lucélia;2021;21092;11058;10034;110.21;18462;2630;87.53;3527405
Lucianópolis;2019;2259;1115;1144;97.47;1836;423;81.27;3527504
Lucianópolis;2020;2261;1115;1146;97.29;1843;418;81.51;3527504
Lucianópolis;2021;2264;1116;1148;97.21;1850;414;81.71;3527504
Luís Antônio;2019;13907;7157;6750;106.03;13689;218;98.43;3527603
Luís Antônio;2020;14166;7287;6879;105.93;13961;205;98.55;3527603
Luís Antônio;2021;14358;7383;6975;105.85;14166;192;98.66;3527603
Luiziânia;2019;5680;2934;2746;106.85;5359;321;94.35;3527702
Luiziânia;2020;5754;2970;2784;106.68;5441;313;94.56;3527702
Luiziânia;2021;5813;2999;2814;106.57;5509;304;94.77;3527702
Lupércio;2019;4414;2138;2276;93.94;4182;232;94.74;3527801
Lupércio;2020;4421;2140;2281;93.82;4196;225;94.91;3527801
Lupércio;2021;4428;2142;2286;93.7;4209;219;95.05;3527801
Lutécia;2019;2629;1302;1327;98.12;2194;435;83.45;3527900
Lutécia;2020;2621;1297;1324;97.96;2197;424;83.82;3527900
Lutécia;2021;2615;1294;1321;97.96;2202;413;84.21;3527900
Macatuba;2019;16867;8435;8432;100.04;16487;380;97.75;3528007
Macatuba;2020;16932;8465;8467;99.98;16559;373;97.8;3528007
Macatuba;2021;16981;8487;8494;99.92;16615;366;97.84;3528007
Macaubal;2019;7746;3883;3863;100.52;7011;735;90.51;3528106
Macaubal;2020;7749;3881;3868;100.34;7028;721;90.7;3528106
Macaubal;2021;7738;3873;3865;100.21;7031;707;90.86;3528106
Macedônia;2019;3582;1777;1805;98.45;2838;744;79.23;3528205
Macedônia;2020;3574;1771;1803;98.23;2844;730;79.57;3528205
Macedônia;2021;3562;1763;1799;98;2846;716;79.9;3528205
Magda;2019;3099;1575;1524;103.35;2644;455;85.32;3528304
Magda;2020;3088;1567;1521;103.02;2641;447;85.52;3528304
Magda;2021;3076;1559;1517;102.77;2638;438;85.76;3528304
Mairinque;2019;46027;22812;23215;98.26;36940;9087;80.26;3528403
Mairinque;2020;46323;22945;23378;98.15;37178;9145;80.26;3528403
Mairinque;2021;46569;23054;23515;98.04;37375;9194;80.26;3528403
Mairiporã;2019;96856;48633;48223;100.85;88912;7944;91.8;3528502
Mairiporã;2020;98622;49481;49141;100.69;90911;7711;92.18;3528502
Mairiporã;2021;100034;50155;49879;100.55;92576;7458;92.54;3528502
Manduri;2019;9475;4702;4773;98.51;8698;777;91.8;3528601
Manduri;2020;9525;4721;4804;98.27;8786;739;92.24;3528601
Manduri;2021;9562;4735;4827;98.09;8860;702;92.66;3528601
Marabá Paulista;2019;4918;3079;1839;167.43;2189;2729;44.51;3528700
Marabá Paulista;2020;4931;3084;1847;166.97;2195;2736;44.51;3528700
Marabá Paulista;2021;4942;3088;1854;166.56;2200;2742;44.52;3528700
Maracaí;2019;13505;6702;6803;98.52;12468;1037;92.32;3528809
Maracaí;2020;13521;6705;6816;98.37;12503;1018;92.47;3528809
Maracaí;2021;13526;6703;6823;98.24;12527;999;92.61;3528809
Marapoama;2019;2880;1465;1415;103.53;2582;298;89.65;3528858
Marapoama;2020;2906;1477;1429;103.36;2617;289;90.06;3528858
Marapoama;2021;2925;1485;1440;103.13;2645;280;90.43;3528858
Mariápolis;2019;3969;2026;1943;104.27;3382;587;85.21;3528908
Mariápolis;2020;3975;2027;1948;104.06;3406;569;85.69;3528908
Mariápolis;2021;3979;2029;1950;104.05;3428;551;86.15;3528908
Marília;2019;230154;111011;119143;93.17;219828;10326;95.51;3529005
Marília;2020;231554;111671;119883;93.15;221166;10388;95.51;3529005
Marília;2021;232599;112167;120432;93.14;222164;10435;95.51;3529005
Marinópolis;2019;2098;1058;1040;101.73;1722;376;82.08;3529104
Marinópolis;2020;2097;1058;1039;101.83;1728;369;82.4;3529104
Marinópolis;2021;2096;1058;1038;101.93;1733;363;82.68;3529104
Martinópolis;2019;25526;13182;12344;106.79;22118;3408;86.65;3529203
Martinópolis;2020;25668;13246;12422;106.63;22310;3358;86.92;3529203
Martinópolis;2021;25778;13298;12480;106.55;22473;3305;87.18;3529203
Matão;2019;79736;39311;40425;97.24;78273;1463;98.17;3529302
Matão;2020;80020;39430;40590;97.14;78552;1468;98.17;3529302
Matão;2021;80174;39486;40688;97.05;78703;1471;98.17;3529302
Mauá;2019;456020;222777;233243;95.51;456020;;100;3529401
Mauá;2020;460132;224753;235379;95.49;460132;;100;3529401
Mauá;2021;463338;226284;237054;95.46;463338;;100;3529401
Mendonça;2019;5006;2521;2485;101.45;4333;673;86.56;3529500
Mendonça;2020;5043;2538;2505;101.32;4386;657;86.97;3529500
Mendonça;2021;5069;2549;2520;101.15;4428;641;87.35;3529500
Meridiano;2019;3751;1814;1937;93.65;2706;1045;72.14;3529609
Meridiano;2020;3739;1805;1934;93.33;2709;1030;72.45;3529609
Meridiano;2021;3725;1795;1930;93.01;2709;1016;72.72;3529609
Mesópolis;2019;1892;943;949;99.37;1623;269;85.78;3529658
Mesópolis;2020;1893;942;951;99.05;1635;258;86.37;3529658
Mesópolis;2021;1893;941;952;98.84;1646;247;86.95;3529658
Miguelópolis;2019;21333;10593;10740;98.63;20349;984;95.39;3529708
Miguelópolis;2020;21424;10633;10791;98.54;20459;965;95.5;3529708
Miguelópolis;2021;21500;10666;10834;98.45;20554;946;95.6;3529708
Mineiros do Tietê;2019;12542;6220;6322;98.39;11981;561;95.53;3529807
Mineiros do Tietê;2020;12597;6245;6352;98.32;12034;563;95.53;3529807
Mineiros do Tietê;2021;12641;6264;6377;98.23;12076;565;95.53;3529807
Mira Estrela;2019;2928;1442;1486;97.04;1953;975;66.7;3530003
Mira Estrela;2020;2939;1446;1493;96.85;1960;979;66.69;3530003
Mira Estrela;2021;2949;1449;1500;96.6;1967;982;66.7;3530003
Miracatu;2019;19952;9926;10026;99;10726;9226;53.76;3529906
Miracatu;2020;19934;9901;10033;98.68;10767;9167;54.01;3529906
Miracatu;2021;19961;9902;10059;98.44;10833;9128;54.27;3529906
Mirandópolis;2019;28543;15491;13052;118.69;26008;2535;91.12;3530102
Mirandópolis;2020;28646;15534;13112;118.47;26161;2485;91.33;3530102
Mirandópolis;2021;28715;15563;13152;118.33;26282;2433;91.53;3530102
Mirante do Paranapanema;2019;17701;8883;8818;100.74;10423;7278;58.88;3530201
Mirante do Paranapanema;2020;17769;8907;8862;100.51;10463;7306;58.88;3530201
Mirante do Paranapanema;2021;17831;8930;8901;100.33;10500;7331;58.89;3530201
Mirassol;2019;57442;28173;29269;96.26;55991;1451;97.47;3530300
Mirassol;2020;57824;28358;29466;96.24;56363;1461;97.47;3530300
Mirassol;2021;58112;28497;29615;96.22;56644;1468;97.47;3530300
Mirassolândia;2019;4661;2364;2297;102.92;3790;871;81.31;3530409
Mirassolândia;2020;4702;2383;2319;102.76;3823;879;81.31;3530409
Mirassolândia;2021;4736;2399;2337;102.65;3851;885;81.31;3530409
Mococa;2019;66703;33080;33623;98.39;63245;3458;94.82;3530508
Mococa;2020;66753;33085;33668;98.27;63433;3320;95.03;3530508
Mococa;2021;66719;33050;33669;98.16;63533;3186;95.22;3530508
Mogi das Cruzes;2019;428384;208480;219904;94.81;397077;31307;92.69;3530607
Mogi das Cruzes;2020;432905;210668;222237;94.79;401520;31385;92.75;3530607
Mogi das Cruzes;2021;436883;212588;224295;94.78;405463;31420;92.81;3530607
Mogi Guaçu;2019;147259;72718;74541;97.55;141153;6106;95.85;3530706
Mogi Guaçu;2020;148325;73207;75118;97.46;142302;6023;95.94;3530706
Mogi Guaçu;2021;149071;73538;75533;97.36;143140;5931;96.02;3530706
Mogi Mirim;2019;90089;44167;45922;96.18;86102;3987;95.57;3530805
Mogi Mirim;2020;90439;44315;46124;96.08;86584;3855;95.74;3530805
Mogi Mirim;2021;90657;44400;46257;95.99;86932;3725;95.89;3530805
Mombuca;2019;3326;1681;1645;102.19;2926;400;87.97;3530904
Mombuca;2020;3332;1683;1649;102.06;2948;384;88.48;3530904
Mombuca;2021;3338;1685;1653;101.94;2969;369;88.95;3530904
Mongaguá;2019;53784;26605;27179;97.89;53549;235;99.56;3531100
Mongaguá;2020;54610;26995;27615;97.75;54372;238;99.56;3531100
Mongaguá;2021;55216;27287;27929;97.7;54975;241;99.56;3531100
Monte Alegre do Sul;2019;7695;3837;3858;99.46;4755;2940;61.79;3531209
Monte Alegre do Sul;2020;7749;3863;3886;99.41;4827;2922;62.29;3531209
Monte Alegre do Sul;2021;7792;3882;3910;99.28;4893;2899;62.8;3531209
Monte Alto;2019;48256;23686;24570;96.4;46699;1557;96.77;3531308
Monte Alto;2020;48405;23750;24655;96.33;46900;1505;96.89;3531308
Monte Alto;2021;48469;23772;24697;96.25;47016;1453;97;3531308
Monte Aprazível;2019;23319;11502;11817;97.33;21626;1693;92.74;3531407
Monte Aprazível;2020;23458;11561;11897;97.18;21781;1677;92.85;3531407
Monte Aprazível;2021;23561;11605;11956;97.06;21901;1660;92.95;3531407
Monte Azul Paulista;2019;18263;9080;9183;98.88;17396;867;95.25;3531506
Monte Azul Paulista;2020;18191;9037;9154;98.72;17350;841;95.38;3531506
Monte Azul Paulista;2021;18131;9001;9130;98.59;17314;817;95.49;3531506
Monte Castelo;2019;3997;1960;2037;96.22;3324;673;83.16;3531605
Monte Castelo;2020;3991;1955;2036;96.02;3336;655;83.59;3531605
Monte Castelo;2021;3985;1951;2034;95.92;3347;638;83.99;3531605
Monte Mor;2019;58508;29101;29407;98.96;55805;2703;95.38;3531803
Monte Mor;2020;59614;29636;29978;98.86;56936;2678;95.51;3531803
Monte Mor;2021;60555;30090;30465;98.77;57909;2646;95.63;3531803
Monteiro Lobato;2019;4431;2282;2149;106.19;1962;2469;44.28;3531704
Monteiro Lobato;2020;4465;2297;2168;105.95;1983;2482;44.41;3531704
Monteiro Lobato;2021;4491;2308;2183;105.73;2000;2491;44.53;3531704
Monções;2019;2172;1104;1068;103.37;1893;279;87.15;3531001
Monções;2020;2175;1104;1071;103.08;1898;277;87.26;3531001
Monções;2021;2173;1102;1071;102.89;1898;275;87.34;3531001
Morro Agudo;2019;32012;16267;15745;103.32;31216;796;97.51;3531902
Morro Agudo;2020;32332;16421;15911;103.21;31558;774;97.61;3531902
Morro Agudo;2021;32603;16550;16053;103.1;31848;755;97.68;3531902
Morungaba;2019;13101;6532;6569;99.44;11755;1346;89.73;3532009
Morungaba;2020;13247;6601;6646;99.32;11938;1309;90.12;3532009
Morungaba;2021;13359;6654;6705;99.24;12089;1270;90.49;3532009
Motuca;2019;4604;2312;2292;100.87;3647;957;79.21;3532058
Motuca;2020;4638;2327;2311;100.69;3705;933;79.88;3532058
Motuca;2021;4665;2338;2327;100.47;3756;909;80.51;3532058
Murutinga do Sul;2019;4273;2109;2164;97.46;2626;1647;61.46;3532108
Murutinga do Sul;2020;4281;2110;2171;97.19;2631;1650;61.46;3532108
Murutinga do Sul;2021;4283;2109;2174;97.01;2633;1650;61.48;3532108
Nantes;2019;3035;1511;1524;99.15;2893;142;95.32;3532157
Nantes;2020;3071;1528;1543;99.03;2937;134;95.64;3532157
Nantes;2021;3103;1544;1559;99.04;2976;127;95.91;3532157
Narandiba;2019;4783;2407;2376;101.3;3851;932;80.51;3532207
Narandiba;2020;4841;2435;2406;101.21;3935;906;81.28;3532207
Narandiba;2021;4888;2458;2430;101.15;4009;879;82.02;3532207
Natividade da Serra;2019;6694;3441;3253;105.78;2838;3856;42.4;3532306
Natividade da Serra;2020;6698;3437;3261;105.4;2844;3854;42.46;3532306
Natividade da Serra;2021;6703;3435;3268;105.11;2851;3852;42.53;3532306
Nazaré Paulista;2019;18242;9302;8940;104.05;17539;703;96.15;3532405
Nazaré Paulista;2020;18445;9396;9049;103.83;17810;635;96.56;3532405
Nazaré Paulista;2021;18611;9472;9139;103.64;18033;578;96.89;3532405
Neves Paulista;2019;8639;4264;4375;97.46;7938;701;91.89;3532504
Neves Paulista;2020;8620;4252;4368;97.34;7932;688;92.02;3532504
Neves Paulista;2021;8592;4236;4356;97.25;7917;675;92.14;3532504
Nhandeara;2019;10784;5271;5513;95.61;9030;1754;83.74;3532603
Nhandeara;2020;10782;5266;5516;95.47;9057;1725;84;3532603
Nhandeara;2021;10760;5252;5508;95.35;9067;1693;84.27;3532603
Nipoã;2019;4905;2564;2341;109.53;4444;461;90.6;3532702
Nipoã;2020;4969;2594;2375;109.22;4510;459;90.76;3532702
Nipoã;2021;5014;2615;2399;109;4558;456;90.91;3532702
Nova Aliança;2019;6396;3160;3236;97.65;5564;832;86.99;3532801
Nova Aliança;2020;6450;3186;3264;97.61;5635;815;87.36;3532801
Nova Aliança;2021;6487;3203;3284;97.53;5689;798;87.7;3532801
Nova Campina;2019;9549;4843;4706;102.91;7476;2073;78.29;3532827
Nova Campina;2020;9675;4904;4771;102.79;7671;2004;79.29;3532827
Nova Campina;2021;9787;4958;4829;102.67;7854;1933;80.25;3532827
Nova Canaã Paulista;2019;1953;986;967;101.96;969;984;49.62;3532843
Nova Canaã Paulista;2020;1937;977;960;101.77;979;958;50.54;3532843
Nova Canaã Paulista;2021;1921;968;953;101.57;988;933;51.43;3532843
Nova Castilho;2019;1172;572;600;95.33;922;250;78.67;3532868
Nova Castilho;2020;1176;573;603;95.02;938;238;79.76;3532868
Nova Castilho;2021;1180;574;606;94.72;954;226;80.85;3532868
Nova Europa;2019;10605;5235;5370;97.49;10050;555;94.77;3532900
Nova Europa;2020;10749;5300;5449;97.27;10204;545;94.93;3532900
Nova Europa;2021;10863;5351;5512;97.08;10328;535;95.08;3532900
Nova Granada;2019;20748;10420;10328;100.89;19423;1325;93.61;3533007
Nova Granada;2020;20918;10503;10415;100.84;19592;1326;93.66;3533007
Nova Granada;2021;21054;10569;10485;100.8;19727;1327;93.7;3533007
Nova Guataporanga;2019;2190;1092;1098;99.45;1962;228;89.59;3533106
Nova Guataporanga;2020;2191;1091;1100;99.18;1969;222;89.87;3533106
Nova Guataporanga;2021;2192;1091;1101;99.09;1976;216;90.15;3533106
Nova Independência;2019;3668;1816;1852;98.06;3102;566;84.57;3533205
Nova Independência;2020;3731;1847;1884;98.04;3172;559;85.02;3533205
Nova Independência;2021;3774;1868;1906;98.01;3226;548;85.48;3533205
Nova Luzitânia;2019;3989;2080;1909;108.96;3719;270;93.23;3533304
Nova Luzitânia;2020;4044;2106;1938;108.67;3782;262;93.52;3533304
Nova Luzitânia;2021;4083;2124;1959;108.42;3830;253;93.8;3533304
Nova Odessa;2019;57399;28373;29026;97.75;56464;935;98.37;3533403
Nova Odessa;2020;58039;28687;29352;97.73;57093;946;98.37;3533403
Nova Odessa;2021;58490;28905;29585;97.7;57537;953;98.37;3533403
Novais;2019;5423;2889;2534;114.01;5051;372;93.14;3533254
Novais;2020;5509;2931;2578;113.69;5137;372;93.25;3533254
Novais;2021;5575;2963;2612;113.44;5203;372;93.33;3533254
Novo Horizonte;2019;38728;19259;19469;98.92;36305;2423;93.74;3533502
Novo Horizonte;2020;38954;19364;19590;98.85;36529;2425;93.77;3533502
Novo Horizonte;2021;39124;19442;19682;98.78;36698;2426;93.8;3533502
Nuporanga;2019;7225;3597;3628;99.15;6864;361;95;3533601
Nuporanga;2020;7268;3616;3652;99.01;6926;342;95.29;3533601
Nuporanga;2021;7297;3628;3669;98.88;6973;324;95.56;3533601
Ocauçu;2019;4147;2099;2048;102.49;3561;586;85.87;3533700
Ocauçu;2020;4146;2095;2051;102.15;3582;564;86.4;3533700
Ocauçu;2021;4143;2091;2052;101.9;3600;543;86.89;3533700
Óleo;2019;2538;1257;1281;98.13;1812;726;71.39;3533809
Óleo;2020;2527;1250;1277;97.89;1818;709;71.94;3533809
Óleo;2021;2517;1244;1273;97.72;1825;692;72.51;3533809
Olímpia;2019;52285;25699;26586;96.66;49885;2400;95.41;3533908
Olímpia;2020;52516;25803;26713;96.59;50148;2368;95.49;3533908
Olímpia;2021;52670;25870;26800;96.53;50336;2334;95.57;3533908
Onda Verde;2019;4192;2138;2054;104.09;3546;646;84.59;3534005
Onda Verde;2020;4225;2154;2071;104.01;3597;628;85.14;3534005
Onda Verde;2021;4250;2166;2084;103.93;3639;611;85.62;3534005
Oriente;2019;6248;3041;3207;94.82;5936;312;95.01;3534104
Oriente;2020;6265;3048;3217;94.75;5956;309;95.07;3534104
Oriente;2021;6275;3052;3223;94.69;5970;305;95.14;3534104
Orindiúva;2019;6752;3411;3341;102.1;6294;458;93.22;3534203
Orindiúva;2020;6866;3465;3401;101.88;6405;461;93.29;3534203
Orindiúva;2021;6951;3505;3446;101.71;6489;462;93.35;3534203
Orlândia;2019;42033;20575;21458;95.88;40950;1083;97.42;3534302
Orlândia;2020;42266;20687;21579;95.87;41177;1089;97.42;3534302
Orlândia;2021;42436;20768;21668;95.85;41343;1093;97.42;3534302
Osasco;2019;679356;326952;352404;92.78;679356;;100;3534401
Osasco;2020;680964;327774;353190;92.8;680964;;100;3534401
Osasco;2021;682876;328742;354134;92.83;682876;;100;3534401
Oscar Bressane;2019;2516;1205;1311;91.91;2195;321;87.24;3534500
Oscar Bressane;2020;2514;1204;1310;91.91;2203;311;87.63;3534500
Oscar Bressane;2021;2508;1201;1307;91.89;2207;301;88;3534500
Osvaldo Cruz;2019;31236;15572;15664;99.41;28471;2765;91.15;3534609
Osvaldo Cruz;2020;31263;15573;15690;99.25;28537;2726;91.28;3534609
Osvaldo Cruz;2021;31256;15560;15696;99.13;28570;2686;91.41;3534609
Ourinhos;2019;109763;53229;56534;94.15;106928;2835;97.42;3534708
Ourinhos;2020;110489;53580;56909;94.15;107635;2854;97.42;3534708
Ourinhos;2021;111039;53845;57194;94.14;108171;2868;97.42;3534708
Ouro Verde;2019;8221;4048;4173;97;7725;496;93.97;3534807
Ouro Verde;2020;8268;4069;4199;96.9;7784;484;94.15;3534807
Ouro Verde;2021;8306;4086;4220;96.82;7834;472;94.32;3534807
Ouroeste;2019;9645;4770;4875;97.85;8974;671;93.04;3534757
Ouroeste;2020;9777;4832;4945;97.71;9111;666;93.19;3534757
Ouroeste;2021;9871;4876;4995;97.62;9210;661;93.3;3534757
Pacaembu;2019;13073;7615;5458;139.52;9632;3441;73.68;3534906
Pacaembu;2020;13056;7602;5454;139.38;9620;3436;73.68;3534906
Pacaembu;2021;13041;7592;5449;139.33;9609;3432;73.68;3534906
Palestina;2019;12060;6072;5988;101.4;10341;1719;85.75;3535002
Palestina;2020;12160;6119;6041;101.29;10458;1702;86;3535002
Palestina;2021;12220;6146;6074;101.19;10539;1681;86.24;3535002
Palmares Paulista;2019;12794;6781;6013;112.77;12425;369;97.12;3535101
Palmares Paulista;2020;12997;6881;6116;112.51;12623;374;97.12;3535101
Palmares Paulista;2021;13154;6956;6198;112.23;12775;379;97.12;3535101
Palmeira d'Oeste;2019;9166;4557;4609;98.87;7413;1753;80.87;3535200
Palmeira d'Oeste;2020;9130;4535;4595;98.69;7428;1702;81.36;3535200
Palmeira d'Oeste;2021;9092;4513;4579;98.56;7439;1653;81.82;3535200
Palmital;2019;21561;10497;11064;94.88;20364;1197;94.45;3535309
Palmital;2020;21599;10512;11087;94.81;20431;1168;94.59;3535309
Palmital;2021;21609;10514;11095;94.76;20467;1142;94.72;3535309
Panorama;2019;15138;7526;7612;98.87;14806;332;97.81;3535408
Panorama;2020;15199;7550;7649;98.71;14870;329;97.84;3535408
Panorama;2021;15253;7571;7682;98.56;14926;327;97.86;3535408
Paraguaçu Paulista;2019;43996;22023;21973;100.23;39871;4125;90.62;3535507
Paraguaçu Paulista;2020;44180;22105;22075;100.14;40038;4142;90.62;3535507
Paraguaçu Paulista;2021;44310;22163;22147;100.07;40155;4155;90.62;3535507
Paraibuna;2019;18145;9128;9017;101.23;5470;12675;30.15;3535606
Paraibuna;2020;18230;9161;9069;101.01;5496;12734;30.15;3535606
Paraibuna;2021;18304;9190;9114;100.83;5518;12786;30.15;3535606
Paraíso;2019;6235;3169;3066;103.36;5662;573;90.81;3535705
Paraíso;2020;6269;3185;3084;103.27;5706;563;91.02;3535705
Paraíso;2021;6293;3195;3098;103.13;5741;552;91.23;3535705
Paranapanema;2019;19739;9976;9763;102.18;16907;2832;85.65;3535804
Paranapanema;2020;19962;10081;9881;102.02;17183;2779;86.08;3535804
Paranapanema;2021;20151;10171;9980;101.91;17429;2722;86.49;3535804
Paranapuã;2019;3886;1977;1909;103.56;3555;331;91.48;3535903
Paranapuã;2020;3892;1979;1913;103.45;3568;324;91.68;3535903
Paranapuã;2021;3895;1980;1915;103.39;3577;318;91.84;3535903
Parapuã;2019;10538;5332;5206;102.42;9042;1496;85.8;3536000
Parapuã;2020;10507;5312;5195;102.25;9053;1454;86.16;3536000
Parapuã;2021;10473;5292;5181;102.14;9060;1413;86.51;3536000
Pardinho;2019;6309;3185;3124;101.95;5535;774;87.73;3536109
Pardinho;2020;6392;3224;3168;101.77;5657;735;88.5;3536109
Pardinho;2021;6467;3260;3207;101.65;5769;698;89.21;3536109
PariqueraAçu;2019;19172;9440;9732;97;13516;5656;70.5;3536208
PariqueraAçu;2020;19251;9473;9778;96.88;13610;5641;70.7;3536208
PariqueraAçu;2021;19311;9498;9813;96.79;13691;5620;70.9;3536208
Parisi;2019;2053;1039;1014;102.47;1713;340;83.44;3536257
Parisi;2020;2054;1038;1016;102.17;1719;335;83.69;3536257
Parisi;2021;2053;1036;1017;101.87;1724;329;83.97;3536257
Patrocínio Paulista;2019;14318;7211;7107;101.46;12128;2190;84.7;3536307
Patrocínio Paulista;2020;14463;7278;7185;101.29;12307;2156;85.09;3536307
Patrocínio Paulista;2021;14592;7339;7253;101.19;12472;2120;85.47;3536307
Paulicéia;2019;7067;3634;3433;105.85;6263;804;88.62;3536406
Paulicéia;2020;7146;3671;3475;105.64;6368;778;89.11;3536406
Paulicéia;2021;7213;3703;3510;105.5;6461;752;89.57;3536406
Paulínia;2019;102956;50839;52117;97.55;102861;95;99.91;3536505
Paulínia;2020;105037;51851;53186;97.49;104940;97;99.91;3536505
Paulínia;2021;106781;52694;54087;97.42;106682;99;99.91;3536505
Paulistânia;2019;1771;908;863;105.21;1365;406;77.08;3536570
Paulistânia;2020;1769;906;863;104.98;1379;390;77.95;3536570
Paulistânia;2021;1769;905;864;104.75;1394;375;78.8;3536570
Paulo de Faria;2019;8525;4263;4262;100.02;7808;717;91.59;3536604
Paulo de Faria;2020;8521;4261;4260;100.02;7814;707;91.7;3536604
Paulo de Faria;2021;8520;4260;4260;100;7823;697;91.82;3536604
Pederneiras;2019;45171;22527;22644;99.48;42009;3162;93;3536703
Pederneiras;2020;45570;22709;22861;99.34;42380;3190;93;3536703
Pederneiras;2021;45877;22846;23031;99.2;42665;3212;93;3536703
Pedra Bela;2019;5947;3086;2861;107.86;1683;4264;28.3;3536802
Pedra Bela;2020;5964;3091;2873;107.59;1711;4253;28.69;3536802
Pedra Bela;2021;5974;3093;2881;107.36;1737;4237;29.08;3536802
Pedranópolis;2019;2433;1249;1184;105.49;1551;882;63.75;3536901
Pedranópolis;2020;2422;1243;1179;105.43;1548;874;63.91;3536901
Pedranópolis;2021;2412;1237;1175;105.28;1546;866;64.1;3536901
Pedregulho;2019;16223;8188;8035;101.9;12114;4109;74.67;3537008
Pedregulho;2020;16279;8210;8069;101.75;12172;4107;74.77;3537008
Pedregulho;2021;16319;8224;8095;101.59;12218;4101;74.87;3537008
Pedreira;2019;46081;22764;23317;97.63;45694;387;99.16;3537107
Pedreira;2020;46548;22986;23562;97.56;46157;391;99.16;3537107
Pedreira;2021;46908;23155;23753;97.48;46514;394;99.16;3537107
Pedrinhas Paulista;2019;3004;1487;1517;98.02;2609;395;86.85;3537156
Pedrinhas Paulista;2020;3010;1489;1521;97.9;2621;389;87.08;3537156
Pedrinhas Paulista;2021;3015;1490;1525;97.7;2633;382;87.33;3537156
Pedro de Toledo;2019;10895;5437;5458;99.62;7683;3212;70.52;3537206
Pedro de Toledo;2020;10977;5471;5506;99.36;7759;3218;70.68;3537206
Pedro de Toledo;2021;11055;5504;5551;99.15;7833;3222;70.85;3537206
Penápolis;2019;60568;29469;31099;94.76;58620;1948;96.78;3537305
Penápolis;2020;60774;29560;31214;94.7;58877;1897;96.88;3537305
Penápolis;2021;60902;29617;31285;94.67;59055;1847;96.97;3537305
Pereira Barreto;2019;25352;12392;12960;95.62;23725;1627;93.58;3537404
Pereira Barreto;2020;25391;12404;12987;95.51;23775;1616;93.64;3537404
Pereira Barreto;2021;25411;12409;13002;95.44;23806;1605;93.68;3537404
Pereiras;2019;8333;4218;4115;102.5;5565;2768;66.78;3537503
Pereiras;2020;8428;4264;4164;102.4;5628;2800;66.78;3537503
Pereiras;2021;8507;4302;4205;102.31;5681;2826;66.78;3537503
Peruíbe;2019;65543;31797;33746;94.22;65120;423;99.35;3537602
Peruíbe;2020;66201;32104;34097;94.15;65798;403;99.39;3537602
Peruíbe;2021;66747;32364;34383;94.13;66364;383;99.43;3537602
Piacatu;2019;5832;2918;2914;100.14;5350;482;91.74;3537701
Piacatu;2020;5891;2946;2945;100.03;5422;469;92.04;3537701
Piacatu;2021;5936;2968;2968;100;5481;455;92.33;3537701
Piedade;2019;53383;26974;26409;102.14;25082;28301;46.98;3537800
Piedade;2020;53536;27027;26509;101.95;25239;28297;47.14;3537800
Piedade;2021;53656;27066;26590;101.79;25380;28276;47.3;3537800
Pilar do Sul;2019;28043;14154;13889;101.91;23223;4820;82.81;3537909
Pilar do Sul;2020;28221;14235;13986;101.78;23491;4730;83.24;3537909
Pilar do Sul;2021;28355;14295;14060;101.67;23720;4635;83.65;3537909
Pindamonhangaba;2019;162051;79543;82508;96.41;157534;4517;97.21;3538006
Pindamonhangaba;2020;163611;80289;83322;96.36;159147;4464;97.27;3538006
Pindamonhangaba;2021;164753;80825;83928;96.3;160348;4405;97.33;3538006
Pindorama;2019;16152;8194;7958;102.97;15288;864;94.65;3538105
Pindorama;2020;16255;8239;8016;102.78;15386;869;94.65;3538105
Pindorama;2021;16331;8271;8060;102.62;15458;873;94.65;3538105
Pinhalzinho;2019;14593;7267;7326;99.19;7332;7261;50.24;3538204
Pinhalzinho;2020;14755;7340;7415;98.99;7429;7326;50.35;3538204
Pinhalzinho;2021;14877;7395;7482;98.84;7507;7370;50.46;3538204
Piquerobi;2019;3534;1724;1810;95.25;2803;731;79.32;3538303
Piquerobi;2020;3535;1722;1813;94.98;2818;717;79.72;3538303
Piquerobi;2021;3532;1718;1814;94.71;2829;703;80.1;3538303
Piquete;2019;13683;6619;7064;93.7;12836;847;93.81;3538501
Piquete;2020;13647;6602;7045;93.71;12804;843;93.82;3538501
Piquete;2021;13621;6590;7031;93.73;12782;839;93.84;3538501
Piracaia;2019;26167;12945;13222;97.91;26167;;100;3538600
Piracaia;2020;26287;12996;13291;97.78;26287;;100;3538600
Piracaia;2021;26379;13033;13346;97.65;26379;;100;3538600
Piracicaba;2019;387507;189328;198179;95.53;380407;7100;98.17;3538709
Piracicaba;2020;389873;190456;199417;95.51;382790;7083;98.18;3538709
Piracicaba;2021;391464;191202;200262;95.48;384405;7059;98.2;3538709
Piraju;2019;28572;13839;14733;93.93;26266;2306;91.93;3538808
Piraju;2020;28574;13836;14738;93.88;26324;2250;92.13;3538808
Piraju;2021;28552;13824;14728;93.86;26358;2194;92.32;3538808
Pirajuí;2019;23228;12674;10554;120.09;19038;4190;81.96;3538907
Pirajuí;2020;23259;12689;10570;120.05;19075;4184;82.01;3538907
Pirajuí;2021;23274;12694;10580;119.98;19099;4175;82.06;3538907
Pirangi;2019;10807;5428;5379;100.91;9916;891;91.76;3539004
Pirangi;2020;10823;5430;5393;100.69;9951;872;91.94;3539004
Pirangi;2021;10825;5426;5399;100.5;9973;852;92.13;3539004
Pirapora do Bom Jesus;2019;18516;9129;9387;97.25;18516;;100;3539103
Pirapora do Bom Jesus;2020;18851;9287;9564;97.1;18851;;100;3539103
Pirapora do Bom Jesus;2021;19139;9424;9715;97;19139;;100;3539103
Pirapozinho;2019;26960;13155;13805;95.29;25839;1121;95.84;3539202
Pirapozinho;2020;27213;13276;13937;95.26;26103;1110;95.92;3539202
Pirapozinho;2021;27425;13378;14047;95.24;26326;1099;95.99;3539202
Pirassununga;2019;73366;35784;37582;95.22;68591;4775;93.49;3539301
Pirassununga;2020;73706;35937;37769;95.15;69037;4669;93.67;3539301
Pirassununga;2021;73921;36029;37892;95.08;69362;4559;93.83;3539301
Piratininga;2019;13100;6461;6639;97.32;11449;1651;87.4;3539400
Piratininga;2020;13213;6514;6699;97.24;11570;1643;87.57;3539400
Piratininga;2021;13305;6556;6749;97.14;11673;1632;87.73;3539400
Pitangueiras;2019;38258;19408;18850;102.96;37255;1003;97.38;3539509
Pitangueiras;2020;38584;19562;19022;102.84;37614;970;97.49;3539509
Pitangueiras;2021;38852;19688;19164;102.73;37915;937;97.59;3539509
Planalto;2019;5098;2626;2472;106.23;4507;591;88.41;3539608
Planalto;2020;5167;2660;2507;106.1;4585;582;88.74;3539608
Planalto;2021;5221;2687;2534;106.04;4649;572;89.04;3539608
Platina;2019;3470;1790;1680;106.55;2856;614;82.31;3539707
Platina;2020;3501;1805;1696;106.43;2894;607;82.66;3539707
Platina;2021;3528;1817;1711;106.2;2928;600;82.99;3539707
Poá;2019;114625;55637;58988;94.32;112814;1811;98.42;3539806
Poá;2020;115538;56096;59442;94.37;113713;1825;98.42;3539806
Poá;2021;116289;56471;59818;94.4;114452;1837;98.42;3539806
Poloni;2019;5641;2777;2864;96.96;5021;620;89.01;3539905
Poloni;2020;5667;2788;2879;96.84;5044;623;89.01;3539905
Poloni;2021;5681;2794;2887;96.78;5057;624;89.02;3539905
Pompéia;2019;21154;10367;10787;96.11;19821;1333;93.7;3540002
Pompéia;2020;21282;10429;10853;96.09;19954;1328;93.76;3540002
Pompéia;2021;21384;10478;10906;96.08;20063;1321;93.82;3540002
Pongaí;2019;3359;1698;1661;102.23;2946;413;87.7;3540101
Pongaí;2020;3351;1691;1660;101.87;2951;400;88.06;3540101
Pongaí;2021;3340;1684;1656;101.69;2952;388;88.38;3540101
Pontal;2019;48465;25570;22895;111.68;47945;520;98.93;3540200
Pontal;2020;49283;25970;23313;111.4;48784;499;98.99;3540200
Pontal;2021;49889;26261;23628;111.14;49411;478;99.04;3540200
Pontalinda;2019;4448;2328;2120;109.81;3879;569;87.21;3540259
Pontalinda;2020;4487;2346;2141;109.57;3929;558;87.56;3540259
Pontalinda;2021;4515;2358;2157;109.32;3970;545;87.93;3540259
Pontes Gestal;2019;2526;1240;1286;96.42;2238;288;88.6;3540309
Pontes Gestal;2020;2528;1239;1289;96.12;2249;279;88.96;3540309
Pontes Gestal;2021;2530;1239;1291;95.97;2259;271;89.29;3540309
Populina;2019;4015;2003;2012;99.55;3356;659;83.59;3540408
Populina;2020;3995;1990;2005;99.25;3351;644;83.88;3540408
Populina;2021;3977;1979;1998;99.05;3346;631;84.13;3540408
Porangaba;2019;9215;4670;4545;102.75;4449;4766;48.28;3540507
Porangaba;2020;9310;4712;4598;102.48;4495;4815;48.28;3540507
Porangaba;2021;9380;4742;4638;102.24;4529;4851;48.28;3540507
Porto Feliz;2019;51422;25691;25731;99.84;44635;6787;86.8;3540606
Porto Feliz;2020;51697;25817;25880;99.76;45016;6681;87.08;3540606
Porto Feliz;2021;51907;25909;25998;99.66;45340;6567;87.35;3540606
Porto Ferreira;2019;53854;26581;27273;97.46;52888;966;98.21;3540705
Porto Ferreira;2020;54102;26691;27411;97.37;53132;970;98.21;3540705
Porto Ferreira;2021;54274;26764;27510;97.29;53300;974;98.21;3540705
Potim;2019;20568;11494;9074;126.67;15597;4971;75.83;3540754
Potim;2020;20702;11555;9147;126.33;15699;5003;75.83;3540754
Potim;2021;20815;11606;9209;126.03;15784;5031;75.83;3540754
Potirendaba;2019;16501;8359;8142;102.67;15158;1343;91.86;3540804
Potirendaba;2020;16605;8409;8196;102.6;15278;1327;92.01;3540804
Potirendaba;2021;16677;8443;8234;102.54;15368;1309;92.15;3540804
Pracinha;2019;2907;2092;815;256.69;1392;1515;47.88;3540853
Pracinha;2020;2913;2094;819;255.68;1395;1518;47.89;3540853
Pracinha;2021;2921;2098;823;254.92;1399;1522;47.89;3540853
Pradópolis;2019;20575;10434;10141;102.89;19180;1395;93.22;3540903
Pradópolis;2020;20907;10593;10314;102.71;19502;1405;93.28;3540903
Pradópolis;2021;21167;10716;10451;102.54;19757;1410;93.34;3540903
Praia Grande;2019;311480;149521;161959;92.32;311480;;100;3541000
Praia Grande;2020;316844;152091;164753;92.31;316844;;100;3541000
Praia Grande;2021;321008;154106;166902;92.33;321008;;100;3541000
Pratânia;2019;5098;2623;2475;105.98;4129;969;80.99;3541059
Pratânia;2020;5156;2651;2505;105.83;4203;953;81.52;3541059
Pratânia;2021;5210;2677;2533;105.68;4273;937;82.02;3541059
Presidente Alves;2019;4028;1993;2035;97.94;3527;501;87.56;3541109
Presidente Alves;2020;4020;1990;2030;98.03;3537;483;87.99;3541109
Presidente Alves;2021;4011;1986;2025;98.07;3545;466;88.38;3541109
Presidente Bernardes;2019;13710;6695;7015;95.44;11396;2314;83.12;3541208
Presidente Bernardes;2020;13720;6693;7027;95.25;11480;2240;83.67;3541208
Presidente Bernardes;2021;13713;6686;7027;95.15;11547;2166;84.2;3541208
Presidente Epitácio;2019;42286;20577;21709;94.79;39705;2581;93.9;3541307
Presidente Epitácio;2020;42400;20622;21778;94.69;39839;2561;93.96;3541307
Presidente Epitácio;2021;42484;20655;21829;94.62;39944;2540;94.02;3541307
Presidente Prudente;2019;219805;105672;114133;92.59;215321;4484;97.96;3541406
Presidente Prudente;2020;221073;106275;114798;92.58;216563;4510;97.96;3541406
Presidente Prudente;2021;221938;106693;115245;92.58;217411;4527;97.96;3541406
Presidente Venceslau;2019;38002;18943;19059;99.39;36837;1165;96.93;3541505
Presidente Venceslau;2020;38005;18945;19060;99.4;36873;1132;97.02;3541505
Presidente Venceslau;2021;37981;18934;19047;99.41;36880;1101;97.1;3541505
Promissão;2019;39268;19431;19837;97.95;33699;5569;85.82;3541604
Promissão;2020;39667;19617;20050;97.84;34106;5561;85.98;3541604
Promissão;2021;40001;19773;20228;97.75;34456;5545;86.14;3541604
Quadra;2019;3662;1903;1759;108.19;947;2715;25.86;3541653
Quadra;2020;3708;1924;1784;107.85;960;2748;25.89;3541653
Quadra;2021;3745;1941;1804;107.59;971;2774;25.93;3541653
Quatá;2019;13822;6877;6945;99.02;13118;704;94.91;3541703
Quatá;2020;13935;6931;7004;98.96;13234;701;94.97;3541703
Quatá;2021;14025;6975;7050;98.94;13328;697;95.03;3541703
Queiroz;2019;3230;1641;1589;103.27;2893;337;89.57;3541802
Queiroz;2020;3279;1666;1613;103.29;2949;330;89.94;3541802
Queiroz;2021;3319;1686;1633;103.25;2997;322;90.3;3541802
Queluz;2019;12523;6363;6160;103.3;10271;2252;82.02;3541901
Queluz;2020;12644;6423;6221;103.25;10370;2274;82.02;3541901
Queluz;2021;12735;6468;6267;103.21;10445;2290;82.02;3541901
Quintana;2019;6451;3179;3272;97.16;5958;493;92.36;3542008
Quintana;2020;6500;3202;3298;97.09;6009;491;92.45;3542008
Quintana;2021;6539;3221;3318;97.08;6050;489;92.52;3542008
Rafard;2019;8934;4410;4524;97.48;8035;899;89.94;3542107
Rafard;2020;8976;4430;4546;97.45;8089;887;90.12;3542107
Rafard;2021;9014;4448;4566;97.42;8140;874;90.3;3542107
Rancharia;2019;28837;14110;14727;95.81;26424;2413;91.63;3542206
Rancharia;2020;28847;14110;14737;95.75;26488;2359;91.82;3542206
Rancharia;2021;28855;14113;14742;95.73;26548;2307;92;3542206
Redenção da Serra;2019;3839;1980;1859;106.51;2723;1116;70.93;3542305
Redenção da Serra;2020;3837;1977;1860;106.29;2773;1064;72.27;3542305
Redenção da Serra;2021;3834;1973;1861;106.02;2821;1013;73.58;3542305
Regente Feijó;2019;19395;9573;9822;97.46;18184;1211;93.76;3542404
Regente Feijó;2020;19491;9614;9877;97.34;18302;1189;93.9;3542404
Regente Feijó;2021;19556;9642;9914;97.26;18391;1165;94.04;3542404
Reginópolis;2019;7224;4594;2630;174.68;4303;2921;59.57;3542503
Reginópolis;2020;7215;4588;2627;174.65;4298;2917;59.57;3542503
Reginópolis;2021;7204;4581;2623;174.65;4291;2913;59.56;3542503
Registro;2019;54174;26524;27650;95.93;48092;6082;88.77;3542602
Registro;2020;54216;26535;27681;95.86;48129;6087;88.77;3542602
Registro;2021;54270;26554;27716;95.81;48177;6093;88.77;3542602
Restinga;2019;7401;3697;3704;99.81;6074;1327;82.07;3542701
Restinga;2020;7493;3742;3751;99.76;6176;1317;82.42;3542701
Restinga;2021;7575;3782;3793;99.71;6270;1305;82.77;3542701
Ribeira;2019;3249;1656;1593;103.95;1456;1793;44.81;3542800
Ribeira;2020;3242;1649;1593;103.52;1483;1759;45.74;3542800
Ribeira;2021;3240;1646;1594;103.26;1511;1729;46.64;3542800
Ribeirão Bonito;2019;12874;6447;6427;100.31;12163;711;94.48;3542909
Ribeirão Bonito;2020;12959;6486;6473;100.2;12265;694;94.64;3542909
Ribeirão Bonito;2021;13033;6520;6513;100.11;12355;678;94.8;3542909
Ribeirão Branco;2019;17697;9067;8630;105.06;10354;7343;58.51;3543006
Ribeirão Branco;2020;17685;9056;8629;104.95;10493;7192;59.33;3543006
Ribeirão Branco;2021;17683;9050;8633;104.83;10637;7046;60.15;3543006
Ribeirão Corrente;2019;4625;2373;2252;105.37;3814;811;82.46;3543105
Ribeirão Corrente;2020;4664;2390;2274;105.1;3860;804;82.76;3543105
Ribeirão Corrente;2021;4698;2405;2293;104.88;3903;795;83.08;3543105
Ribeirão do Sul;2019;4366;2174;2192;99.18;3548;818;81.26;3543204
Ribeirão do Sul;2020;4360;2169;2191;99;3572;788;81.93;3543204
Ribeirão do Sul;2021;4351;2163;2188;98.86;3592;759;82.56;3543204
Ribeirão dos Índios;2019;2145;1056;1089;96.97;1893;252;88.25;3543238
Ribeirão dos Índios;2020;2141;1053;1088;96.78;1897;244;88.6;3543238
Ribeirão dos Índios;2021;2135;1050;1085;96.77;1899;236;88.95;3543238
Ribeirão Grande;2019;7501;3790;3711;102.13;2377;5124;31.69;3543253
Ribeirão Grande;2020;7510;3790;3720;101.88;2381;5129;31.7;3543253
Ribeirão Grande;2021;7515;3789;3726;101.69;2383;5132;31.71;3543253
Ribeirão Pires;2019;118441;57908;60533;95.66;118441;;100;3543303
Ribeirão Pires;2020;118968;58158;60810;95.64;118968;;100;3543303
Ribeirão Pires;2021;119339;58326;61013;95.6;119339;;100;3543303
Ribeirão Preto;2019;676440;325300;351140;92.64;674520;1920;99.72;3543402
Ribeirão Preto;2020;683777;328906;354871;92.68;681837;1940;99.72;3543402
Ribeirão Preto;2021;688894;331439;357455;92.72;686939;1955;99.72;3543402
Rifaina;2019;3464;1730;1734;99.77;3071;393;88.65;3543600
Rifaina;2020;3468;1731;1737;99.65;3078;390;88.75;3543600
Rifaina;2021;3470;1731;1739;99.54;3084;386;88.88;3543600
Rincão;2019;10486;5255;5231;100.46;8634;1852;82.34;3543709
Rincão;2020;10496;5257;5239;100.34;8655;1841;82.46;3543709
Rincão;2021;10506;5259;5247;100.23;8676;1830;82.58;3543709
Rinópolis;2019;9738;4895;4843;101.07;8894;844;91.33;3543808
Rinópolis;2020;9720;4881;4839;100.87;8910;810;91.67;3543808
Rinópolis;2021;9700;4868;4832;100.75;8921;779;91.97;3543808
Rio Claro;2019;199765;97157;102608;94.69;195363;4402;97.8;3543907
Rio Claro;2020;201212;97853;103359;94.67;196819;4393;97.82;3543907
Rio Claro;2021;202289;98367;103922;94.65;197912;4377;97.84;3543907
Rio das Pedras;2019;33951;17108;16843;101.57;33201;750;97.79;3544004
Rio das Pedras;2020;34416;17336;17080;101.5;33676;740;97.85;3544004
Rio das Pedras;2021;34768;17506;17262;101.41;34037;731;97.9;3544004
Rio Grande da Serra;2019;49229;24303;24926;97.5;49229;;100;3544103
Rio Grande da Serra;2020;49816;24582;25234;97.42;49816;;100;3544103
Rio Grande da Serra;2021;50313;24816;25497;97.33;50313;;100;3544103
Riolândia;2019;11342;6376;4966;128.39;8973;2369;79.11;3544202
Riolândia;2020;11431;6418;5013;128.03;9043;2388;79.11;3544202
Riolândia;2021;11501;6450;5051;127.7;9099;2402;79.11;3544202
Riversul;2019;5742;2816;2926;96.24;4320;1422;75.24;3543501
Riversul;2020;5705;2796;2909;96.12;4307;1398;75.5;3543501
Riversul;2021;5686;2786;2900;96.07;4307;1379;75.75;3543501
Rosana;2019;18487;9097;9390;96.88;17730;757;95.91;3544251
Rosana;2020;18387;9038;9349;96.67;17719;668;96.37;3544251
Rosana;2021;18320;8996;9324;96.48;17720;600;96.72;3544251
Roseira;2019;10540;5302;5238;101.22;10109;431;95.91;3544301
Roseira;2020;10642;5351;5291;101.13;10216;426;96;3544301
Roseira;2021;10723;5389;5334;101.03;10303;420;96.08;3544301
Rubiácea;2019;3070;1549;1521;101.84;1840;1230;59.93;3544400
Rubiácea;2020;3106;1566;1540;101.69;1871;1235;60.24;3544400
Rubiácea;2021;3138;1581;1557;101.54;1899;1239;60.52;3544400
Rubinéia;2019;2978;1459;1519;96.05;2599;379;87.27;3544509
Rubinéia;2020;2989;1463;1526;95.87;2621;368;87.69;3544509
Rubinéia;2021;2996;1466;1530;95.82;2639;357;88.08;3544509
Sabino;2019;5445;2708;2737;98.94;4954;491;90.98;3544608
Sabino;2020;5468;2717;2751;98.76;4991;477;91.28;3544608
Sabino;2021;5485;2723;2762;98.59;5022;463;91.56;3544608
Sagres;2019;2363;1167;1196;97.58;1973;390;83.5;3544707
Sagres;2020;2362;1166;1196;97.49;1989;373;84.21;3544707
Sagres;2021;2362;1165;1197;97.33;2005;357;84.89;3544707
Sales;2019;5995;3018;2977;101.38;5571;424;92.93;3544806
Sales;2020;6050;3041;3009;101.06;5631;419;93.07;3544806
Sales;2021;6082;3054;3028;100.86;5668;414;93.19;3544806
Sales Oliveira;2019;11430;5646;5784;97.61;10736;694;93.93;3544905
Sales Oliveira;2020;11518;5687;5831;97.53;10850;668;94.2;3544905
Sales Oliveira;2021;11580;5716;5864;97.48;10938;642;94.46;3544905
Salesópolis;2019;16713;8357;8356;100.01;11045;5668;66.09;3545001
Salesópolis;2020;16838;8411;8427;99.81;11173;5665;66.36;3545001
Salesópolis;2021;16945;8457;8488;99.63;11288;5657;66.62;3545001
Salmourão;2019;5085;2592;2493;103.97;4772;313;93.84;3545100
Salmourão;2020;5117;2606;2511;103.78;4818;299;94.16;3545100
Salmourão;2021;5138;2615;2523;103.65;4853;285;94.45;3545100
Saltinho;2019;7790;3855;3935;97.97;6532;1258;83.85;3545159
Saltinho;2020;7860;3886;3974;97.79;6594;1266;83.89;3545159
Saltinho;2021;7898;3902;3996;97.65;6630;1268;83.95;3545159
Salto;2019;114389;56413;57976;97.3;113585;804;99.3;3545209
Salto;2020;115372;56888;58484;97.27;114561;811;99.3;3545209
Salto;2021;116089;57226;58863;97.22;115273;816;99.3;3545209
Salto de Pirapora;2019;43826;21695;22131;98.03;34484;9342;78.68;3545308
Salto de Pirapora;2020;44223;21883;22340;97.95;34810;9413;78.71;3545308
Salto de Pirapora;2021;44522;22023;22499;97.88;35059;9463;78.75;3545308
Salto Grande;2019;9062;4469;4593;97.3;8336;726;91.99;3545407
Salto Grande;2020;9095;4483;4612;97.2;8380;715;92.14;3545407
Salto Grande;2021;9125;4497;4628;97.17;8421;704;92.28;3545407
Sandovalina;2019;4160;2105;2055;102.43;3293;867;79.16;3545506
Sandovalina;2020;4211;2130;2081;102.35;3371;840;80.05;3545506
Sandovalina;2021;4257;2152;2105;102.23;3444;813;80.9;3545506
Santa Adélia;2019;14840;7416;7424;99.89;14040;800;94.61;3545605
Santa Adélia;2020;14892;7442;7450;99.89;14089;803;94.61;3545605
Santa Adélia;2021;14929;7460;7469;99.88;14124;805;94.61;3545605
Santa Albertina;2019;5678;2851;2827;100.85;5046;632;88.87;3545704
Santa Albertina;2020;5672;2845;2827;100.64;5057;615;89.16;3545704
Santa Albertina;2021;5657;2835;2822;100.46;5059;598;89.43;3545704
Santa Bárbara d'Oeste;2019;187926;92861;95065;97.68;186451;1475;99.22;3545803
Santa Bárbara d'Oeste;2020;188745;93233;95512;97.61;187263;1482;99.21;3545803
Santa Bárbara d'Oeste;2021;189330;93482;95848;97.53;187844;1486;99.22;3545803
Santa Branca;2019;14138;7013;7125;98.43;12471;1667;88.21;3546009
Santa Branca;2020;14179;7028;7151;98.28;12507;1672;88.21;3546009
Santa Branca;2021;14212;7039;7173;98.13;12536;1676;88.21;3546009
Santa Clara d'Oeste;2019;2015;1033;982;105.19;1613;402;80.05;3546108
Santa Clara d'Oeste;2020;2006;1028;978;105.11;1614;392;80.46;3546108
Santa Clara d'Oeste;2021;1998;1024;974;105.13;1617;381;80.93;3546108
Santa Cruz da Conceição;2019;4315;2121;2194;96.67;3332;983;77.22;3546207
Santa Cruz da Conceição;2020;4349;2136;2213;96.52;3398;951;78.13;3546207
Santa Cruz da Conceição;2021;4372;2146;2226;96.41;3455;917;79.03;3546207
Santa Cruz da Esperança;2019;2065;1016;1049;96.85;1419;646;68.72;3546256
Santa Cruz da Esperança;2020;2077;1021;1056;96.69;1429;648;68.8;3546256
Santa Cruz da Esperança;2021;2086;1025;1061;96.61;1438;648;68.94;3546256
Santa Cruz das Palmeiras;2019;33356;16870;16486;102.33;32615;741;97.78;3546306
Santa Cruz das Palmeiras;2020;33729;17048;16681;102.2;32998;731;97.83;3546306
Santa Cruz das Palmeiras;2021;34031;17193;16838;102.11;33310;721;97.88;3546306
Santa Cruz do Rio Pardo;2019;45890;22415;23475;95.48;42995;2895;93.69;3546405
Santa Cruz do Rio Pardo;2020;46110;22516;23594;95.43;43274;2836;93.85;3546405
Santa Cruz do Rio Pardo;2021;46276;22592;23684;95.39;43496;2780;93.99;3546405
Santa Ernestina;2019;5528;2831;2697;104.97;5309;219;96.04;3546504
Santa Ernestina;2020;5525;2829;2696;104.93;5316;209;96.22;3546504
Santa Ernestina;2021;5527;2829;2698;104.86;5326;201;96.36;3546504
Santa Fé do Sul;2019;30653;14702;15951;92.17;29446;1207;96.06;3546603
Santa Fé do Sul;2020;30804;14770;16034;92.12;29591;1213;96.06;3546603
Santa Fé do Sul;2021;30897;14813;16084;92.1;29681;1216;96.06;3546603
Santa Gertrudes;2019;25723;12969;12754;101.69;25450;273;98.94;3546702
Santa Gertrudes;2020;26189;13197;12992;101.58;25911;278;98.94;3546702
Santa Gertrudes;2021;26572;13384;13188;101.49;26290;282;98.94;3546702
Santa Isabel;2019;54637;27160;27477;98.85;44211;10426;80.92;3546801
Santa Isabel;2020;55086;27364;27722;98.71;44716;10370;81.17;3546801
Santa Isabel;2021;55436;27521;27915;98.59;45141;10295;81.43;3546801
Santa Lúcia;2019;8532;4242;4290;98.88;8169;363;95.75;3546900
Santa Lúcia;2020;8562;4254;4308;98.75;8208;354;95.87;3546900
Santa Lúcia;2021;8590;4265;4325;98.61;8244;346;95.97;3546900
Santa Maria da Serra;2019;6066;3047;3019;100.93;5500;566;90.67;3547007
Santa Maria da Serra;2020;6141;3082;3059;100.75;5583;558;90.91;3547007
Santa Maria da Serra;2021;6208;3113;3095;100.58;5658;550;91.14;3547007
Santa Mercedes;2019;2814;1395;1419;98.31;2563;251;91.08;3547106
Santa Mercedes;2020;2813;1393;1420;98.1;2572;241;91.43;3547106
Santa Mercedes;2021;2814;1392;1422;97.89;2583;231;91.79;3547106
Santa Rita d'Oeste;2019;2418;1196;1222;97.87;1887;531;78.04;3547403
Santa Rita d'Oeste;2020;2404;1188;1216;97.7;1895;509;78.83;3547403
Santa Rita d'Oeste;2021;2389;1181;1208;97.76;1901;488;79.57;3547403
Santa Rita do Passa Quatro;2019;26397;12764;13633;93.63;24220;2177;91.75;3547502
Santa Rita do Passa Quatro;2020;26385;12757;13628;93.61;24263;2122;91.96;3547502
Santa Rita do Passa Quatro;2021;26355;12742;13613;93.6;24288;2067;92.16;3547502
Santa Rosa de Viterbo;2019;25434;12511;12923;96.81;24452;982;96.14;3547601
Santa Rosa de Viterbo;2020;25604;12591;13013;96.76;24636;968;96.22;3547601
Santa Rosa de Viterbo;2021;25732;12650;13082;96.7;24780;952;96.3;3547601
Santa Salete;2019;1441;730;711;102.67;1013;428;70.3;3547650
Santa Salete;2020;1440;728;712;102.25;1031;409;71.6;3547650
Santa Salete;2021;1438;726;712;101.97;1047;391;72.81;3547650
Santana da Ponte Pensa;2019;1520;767;753;101.86;1115;405;73.36;3547205
Santana da Ponte Pensa;2020;1509;760;749;101.47;1116;393;73.96;3547205
Santana da Ponte Pensa;2021;1497;753;744;101.21;1117;380;74.62;3547205
Santana de Parnaíba;2019;135194;66615;68579;97.14;135194;;100;3547304
Santana de Parnaíba;2020;138132;68057;70075;97.12;138132;;100;3547304
Santana de Parnaíba;2021;140616;69272;71344;97.1;140616;;100;3547304
Santo Anastácio;2019;20153;9796;10357;94.58;18981;1172;94.18;3547700
Santo Anastácio;2020;20127;9781;10346;94.54;18977;1150;94.29;3547700
Santo Anastácio;2021;20106;9770;10336;94.52;18976;1130;94.38;3547700
Santo André;2019;692207;332482;359725;92.43;692207;;100;3547809
Santo André;2020;693867;333318;360549;92.45;693867;;100;3547809
Santo André;2021;694681;333750;360931;92.47;694681;;100;3547809
Santo Antônio da Alegria;2019;6605;3379;3226;104.74;4967;1638;75.2;3547908
Santo Antônio da Alegria;2020;6637;3391;3246;104.47;4999;1638;75.32;3547908
Santo Antônio da Alegria;2021;6661;3400;3261;104.26;5026;1635;75.45;3547908
Santo Antônio de Posse;2019;22635;11340;11295;100.4;21574;1061;95.31;3548005
Santo Antônio de Posse;2020;22849;11441;11408;100.29;21842;1007;95.59;3548005
Santo Antônio de Posse;2021;23027;11525;11502;100.2;22070;957;95.84;3548005
Santo Antônio do Aracanguá;2019;8193;4135;4058;101.9;7067;1126;86.26;3548054
Santo Antônio do Aracanguá;2020;8252;4161;4091;101.71;7174;1078;86.94;3548054
Santo Antônio do Aracanguá;2021;8297;4180;4117;101.53;7268;1029;87.6;3548054
Santo Antônio do Jardim;2019;5834;2975;2859;104.06;3778;2056;64.76;3548104
Santo Antônio do Jardim;2020;5826;2970;2856;103.99;3806;2020;65.33;3548104
Santo Antônio do Jardim;2021;5823;2967;2856;103.89;3837;1986;65.89;3548104
Santo Antônio do Pinhal;2019;6612;3299;3313;99.58;4556;2056;68.91;3548203
Santo Antônio do Pinhal;2020;6628;3304;3324;99.4;4631;1997;69.87;3548203
Santo Antônio do Pinhal;2021;6643;3308;3335;99.19;4705;1938;70.83;3548203
Santo Expedito;2019;2956;1474;1482;99.46;2749;207;93;3548302
Santo Expedito;2020;2972;1482;1490;99.46;2774;198;93.34;3548302
Santo Expedito;2021;2986;1489;1497;99.47;2797;189;93.67;3548302
Santópolis do Aguapeí;2019;4630;2333;2297;101.57;4515;115;97.52;3548401
Santópolis do Aguapeí;2020;4668;2351;2317;101.47;4555;113;97.58;3548401
Santópolis do Aguapeí;2021;4698;2365;2333;101.37;4586;112;97.62;3548401
Santos;2019;427673;197195;230478;85.56;427353;320;99.93;3548500
Santos;2020;428703;197843;230860;85.7;428382;321;99.93;3548500
Santos;2021;429513;198398;231115;85.84;429191;322;99.93;3548500
São Bento do Sapucaí;2019;10520;5257;5263;99.89;5394;5126;51.27;3548609
São Bento do Sapucaí;2020;10530;5258;5272;99.73;5435;5095;51.61;3548609
São Bento do Sapucaí;2021;10539;5258;5281;99.56;5477;5062;51.97;3548609
São Bernardo do Campo;2019;807917;390507;417410;93.55;794875;13042;98.39;3548708
São Bernardo do Campo;2020;812086;392552;419534;93.57;799027;13059;98.39;3548708
São Bernardo do Campo;2021;815109;394025;421084;93.57;802052;13057;98.4;3548708
São Caetano do Sul;2019;151116;70175;80941;86.7;151116;;100;3548807
São Caetano do Sul;2020;151244;70285;80959;86.82;151244;;100;3548807
São Caetano do Sul;2021;151111;70267;80844;86.92;151111;;100;3548807
São Carlos;2019;240726;117925;122801;96.03;231085;9641;96;3548906
São Carlos;2020;242632;118836;123796;95.99;232915;9717;96;3548906
São Carlos;2021;244036;119495;124541;95.95;234262;9774;95.99;3548906
São Francisco;2019;2689;1335;1354;98.6;2198;491;81.74;3549003
São Francisco;2020;2677;1328;1349;98.44;2198;479;82.11;3549003
São Francisco;2021;2667;1323;1344;98.44;2201;466;82.53;3549003
São João da Boa Vista;2019;87008;42139;44869;93.92;84646;2362;97.29;3549102
São João da Boa Vista;2020;87340;42294;45046;93.89;85046;2294;97.37;3549102
São João da Boa Vista;2021;87537;42384;45153;93.87;85308;2229;97.45;3549102
São João das Duas Pontes;2019;2485;1225;1260;97.22;1914;571;77.02;3549201
São João das Duas Pontes;2020;2476;1218;1258;96.82;1908;568;77.06;3549201
São João das Duas Pontes;2021;2466;1211;1255;96.49;1902;564;77.13;3549201
São João de Iracema;2019;1844;923;921;100.22;1635;209;88.67;3549250
São João de Iracema;2020;1850;925;925;100;1652;198;89.3;3549250
São João de Iracema;2021;1853;926;927;99.89;1665;188;89.85;3549250
São João do Pau d'Alho;2019;1995;983;1012;97.13;1715;280;85.96;3549300
São João do Pau d'Alho;2020;1985;976;1009;96.73;1716;269;86.45;3549300
São João do Pau d'Alho;2021;1973;969;1004;96.51;1714;259;86.87;3549300
São Joaquim da Barra;2019;49921;24412;25509;95.7;49039;882;98.23;3549409
São Joaquim da Barra;2020;50274;24580;25694;95.66;49386;888;98.23;3549409
São Joaquim da Barra;2021;50553;24713;25840;95.64;49661;892;98.24;3549409
São José da Bela Vista;2019;8692;4426;4266;103.75;7912;780;91.03;3549508
São José da Bela Vista;2020;8727;4440;4287;103.57;7961;766;91.22;3549508
São José da Bela Vista;2021;8762;4455;4307;103.44;8009;753;91.41;3549508
São José do Barreiro;2019;4069;2027;2042;99.27;3185;884;78.27;3549607
São José do Barreiro;2020;4070;2026;2044;99.12;3217;853;79.04;3549607
São José do Barreiro;2021;4073;2026;2047;98.97;3250;823;79.79;3549607
São José do Rio Pardo;2019;53083;26042;27041;96.31;48770;4313;91.87;3549706
São José do Rio Pardo;2020;53206;26094;27112;96.25;49041;4165;92.17;3549706
São José do Rio Pardo;2021;53277;26120;27157;96.18;49257;4020;92.45;3549706
São José do Rio Preto;2019;444346;214054;230292;92.95;417389;26957;93.93;3549805
São José do Rio Preto;2020;447924;215795;232129;92.96;420750;27174;93.93;3549805
São José do Rio Preto;2021;450361;216998;233363;92.99;423039;27322;93.93;3549805
São José dos Campos;2019;702866;343667;359199;95.68;688567;14299;97.97;3549904
São José dos Campos;2020;710654;347392;363262;95.63;696197;14457;97.97;3549904
São José dos Campos;2021;716688;350251;366437;95.58;702108;14580;97.97;3549904
São Lourenço da Serra;2019;15412;7744;7668;100.99;14315;1097;92.88;3549953
São Lourenço da Serra;2020;15579;7820;7759;100.79;14499;1080;93.07;3549953
São Lourenço da Serra;2021;15721;7884;7837;100.6;14658;1063;93.24;3549953
São Luiz do Paraitinga;2019;10549;5347;5202;102.79;6319;4230;59.9;3550001
São Luiz do Paraitinga;2020;10569;5352;5217;102.59;6337;4232;59.96;3550001
São Luiz do Paraitinga;2021;10584;5356;5228;102.45;6351;4233;60.01;3550001
São Manuel;2019;39450;19258;20192;95.37;38899;551;98.6;3550100
São Manuel;2020;39574;19314;20260;95.33;39042;532;98.66;3550100
São Manuel;2021;39678;19361;20317;95.29;39162;516;98.7;3550100
São Miguel Arcanjo;2019;31936;16149;15787;102.29;24289;7647;76.06;3550209
São Miguel Arcanjo;2020;32000;16172;15828;102.17;24583;7417;76.82;3550209
São Miguel Arcanjo;2021;32115;16221;15894;102.06;24911;7204;77.57;3550209
São Paulo;2019;11811516;5620841;6190675;90.8;11705341;106175;99.1;3550308
São Paulo;2020;11869660;5651451;6218209;90.89;11762962;106698;99.1;3550308
São Paulo;2021;11914851;5675546;6239305;90.96;11807747;107104;99.1;3550308
São Pedro;2019;33966;16477;17489;94.21;29466;4500;86.75;3550407
São Pedro;2020;34208;16589;17619;94.15;29769;4439;87.02;3550407
São Pedro;2021;34408;16684;17724;94.13;30035;4373;87.29;3550407
São Pedro do Turvo;2019;7348;3727;3621;102.93;5681;1667;77.31;3550506
São Pedro do Turvo;2020;7369;3736;3633;102.84;5739;1630;77.88;3550506
São Pedro do Turvo;2021;7389;3745;3644;102.77;5796;1593;78.44;3550506
São Roque;2019;86636;42385;44251;95.78;83498;3138;96.38;3550605
São Roque;2020;87435;42753;44682;95.68;84550;2885;96.7;3550605
São Roque;2021;88032;43025;45007;95.6;85376;2656;96.98;3550605
São Sebastião;2019;85843;42549;43294;98.28;84876;967;98.87;3550704
São Sebastião;2020;87135;43160;43975;98.15;86153;982;98.87;3550704
São Sebastião;2021;88156;43638;44518;98.02;87163;993;98.87;3550704
São Sebastião da Grama;2019;11944;6081;5863;103.72;8435;3509;70.62;3550803
São Sebastião da Grama;2020;11936;6076;5860;103.69;8489;3447;71.12;3550803
São Sebastião da Grama;2021;11929;6070;5859;103.6;8543;3386;71.62;3550803
São Simão;2019;14794;7273;7521;96.7;13631;1163;92.14;3550902
São Simão;2020;14847;7298;7549;96.68;13710;1137;92.34;3550902
São Simão;2021;14891;7320;7571;96.68;13779;1112;92.53;3550902
São Vicente;2019;355352;170961;184391;92.72;354681;671;99.81;3551009
São Vicente;2020;357929;172235;185694;92.75;357253;676;99.81;3551009
São Vicente;2021;360262;173390;186872;92.79;359581;681;99.81;3551009
Sarapuí;2019;9999;5023;4976;100.94;7980;2019;79.81;3551108
Sarapuí;2020;10110;5072;5038;100.67;8130;1980;80.42;3551108
Sarapuí;2021;10206;5115;5091;100.47;8268;1938;81.01;3551108
Sarutaiá;2019;3642;1830;1812;100.99;3131;511;85.97;3551207
Sarutaiá;2020;3646;1832;1814;100.99;3149;497;86.37;3551207
Sarutaiá;2021;3652;1835;1817;100.99;3169;483;86.77;3551207
Sebastianópolis do Sul;2019;3271;1637;1634;100.18;2771;500;84.71;3551306
Sebastianópolis do Sul;2020;3293;1647;1646;100.06;2810;483;85.33;3551306
Sebastianópolis do Sul;2021;3304;1652;1652;100;2838;466;85.9;3551306
Serra Azul;2019;12175;7287;4888;149.08;8672;3503;71.23;3551405
Serra Azul;2020;12282;7337;4945;148.37;8748;3534;71.23;3551405
Serra Azul;2021;12381;7383;4998;147.72;8818;3563;71.22;3551405
Serra Negra;2019;27347;13239;14108;93.84;23807;3540;87.06;3551603
Serra Negra;2020;27440;13276;14164;93.73;23897;3543;87.09;3551603
Serra Negra;2021;27486;13292;14194;93.65;23946;3540;87.12;3551603
Serrana;2019;43890;21904;21986;99.63;43629;261;99.41;3551504
Serrana;2020;44434;22166;22268;99.54;44183;251;99.44;3551504
Serrana;2021;44870;22373;22497;99.45;44629;241;99.46;3551504
Sertãozinho;2019;121229;60069;61160;98.22;120612;617;99.49;3551702
Sertãozinho;2020;122355;60606;61749;98.15;121772;583;99.52;3551702
Sertãozinho;2021;123148;60978;62170;98.08;122595;553;99.55;3551702
Sete Barras;2019;12641;6393;6248;102.32;8981;3660;71.05;3551801
Sete Barras;2020;12628;6376;6252;101.98;9143;3485;72.4;3551801
Sete Barras;2021;12643;6375;6268;101.71;9315;3328;73.68;3551801
Severínia;2019;16965;8727;8238;105.94;16381;584;96.56;3551900
Severínia;2020;17126;8802;8324;105.74;16546;580;96.61;3551900
Severínia;2021;17263;8864;8399;105.54;16687;576;96.66;3551900
Silveiras;2019;6162;3096;3066;100.98;3292;2870;53.42;3552007
Silveiras;2020;6204;3114;3090;100.78;3339;2865;53.82;3552007
Silveiras;2021;6240;3130;3110;100.64;3384;2856;54.23;3552007
Socorro;2019;38595;19091;19504;97.88;27494;11101;71.24;3552106
Socorro;2020;38783;19178;19605;97.82;27762;11021;71.58;3552106
Socorro;2021;38896;19229;19667;97.77;27977;10919;71.93;3552106
Sorocaba;2019;651434;318586;332848;95.72;644804;6630;98.98;3552205
Sorocaba;2020;658547;322056;336491;95.71;651845;6702;98.98;3552205
Sorocaba;2021;663739;324558;339181;95.69;656984;6755;98.98;3552205
Sud Mennucci;2019;7688;3850;3838;100.31;6621;1067;86.12;3552304
Sud Mennucci;2020;7713;3861;3852;100.23;6644;1069;86.14;3552304
Sud Mennucci;2021;7728;3866;3862;100.1;6659;1069;86.17;3552304
Sumaré;2019;279151;138124;141027;97.94;275865;3286;98.82;3552403
Sumaré;2020;283212;140074;143138;97.86;279878;3334;98.82;3552403
Sumaré;2021;286462;141625;144837;97.78;283089;3373;98.82;3552403
Suzanápolis;2019;3894;1984;1910;103.87;2599;1295;66.74;3552551
Suzanápolis;2020;3947;2008;1939;103.56;2634;1313;66.73;3552551
Suzanápolis;2021;3990;2028;1962;103.36;2663;1327;66.74;3552551
Suzano;2019;288115;141042;147073;95.9;277973;10142;96.48;3552502
Suzano;2020;291002;142429;148573;95.86;280758;10244;96.48;3552502
Suzano;2021;293464;143602;149862;95.82;283133;10331;96.48;3552502
Tabapuã;2019;11847;5935;5912;100.39;11097;750;93.67;3552601
Tabapuã;2020;11892;5953;5939;100.24;11145;747;93.72;3552601
Tabapuã;2021;11918;5962;5956;100.1;11173;745;93.75;3552601
Tabatinga;2019;15777;8065;7712;104.58;14194;1583;89.97;3552700
Tabatinga;2020;15897;8120;7777;104.41;14361;1536;90.34;3552700
Tabatinga;2021;15996;8166;7830;104.29;14508;1488;90.7;3552700
Taboão da Serra;2019;279902;134338;145564;92.29;279902;;100;3552809
Taboão da Serra;2020;283871;136294;147577;92.35;283871;;100;3552809
Taboão da Serra;2021;287155;137912;149243;92.41;287155;;100;3552809
Taciba;2019;6020;2991;3029;98.75;5274;746;87.61;3552908
Taciba;2020;6054;3006;3048;98.62;5320;734;87.88;3552908
Taciba;2021;6081;3018;3063;98.53;5360;721;88.14;3552908
Taguaí;2019;13074;6495;6579;98.72;9366;3708;71.64;3553005
Taguaí;2020;13319;6615;6704;98.67;9542;3777;71.64;3553005
Taguaí;2021;13503;6705;6798;98.63;9673;3830;71.64;3553005
Taiaçu;2019;6023;3006;3017;99.64;5603;420;93.03;3553104
Taiaçu;2020;6037;3010;3027;99.44;5629;408;93.24;3553104
Taiaçu;2021;6048;3013;3035;99.28;5651;397;93.44;3553104
Taiúva;2019;6290;3601;2689;133.92;5892;398;93.67;3553203
Taiúva;2020;6278;3594;2684;133.9;5894;384;93.88;3553203
Taiúva;2021;6265;3586;2679;133.86;5893;372;94.06;3553203
Tambaú;2019;22757;11269;11488;98.09;20742;2015;91.15;3553302
Tambaú;2020;22803;11283;11520;97.94;20834;1969;91.37;3553302
Tambaú;2021;22846;11296;11550;97.8;20922;1924;91.58;3553302
Tanabi;2019;25016;12479;12537;99.54;23262;1754;92.99;3553401
Tanabi;2020;25105;12520;12585;99.48;23378;1727;93.12;3553401
Tanabi;2021;25147;12538;12609;99.44;23445;1702;93.23;3553401
Tapiraí;2019;7716;3862;3854;100.21;5771;1945;74.79;3553500
Tapiraí;2020;7699;3850;3849;100.03;5785;1914;75.14;3553500
Tapiraí;2021;7705;3850;3855;99.87;5816;1889;75.48;3553500
Tapiratiba;2019;12618;6204;6414;96.73;11235;1383;89.04;3553609
Tapiratiba;2020;12610;6193;6417;96.51;11298;1312;89.6;3553609
Tapiratiba;2021;12602;6184;6418;96.35;11357;1245;90.12;3553609
Taquaral;2019;2747;1380;1367;100.95;2654;93;96.61;3553658
Taquaral;2020;2751;1382;1369;100.95;2660;91;96.69;3553658
Taquaral;2021;2753;1382;1371;100.8;2664;89;96.77;3553658
Taquaritinga;2019;54439;26781;27658;96.83;52316;2123;96.1;3553708
Taquaritinga;2020;54499;26800;27699;96.75;52424;2075;96.19;3553708
Taquaritinga;2021;54531;26806;27725;96.69;52500;2031;96.28;3553708
Taquarituba;2019;23111;11498;11613;99.01;20997;2114;90.85;3553807
Taquarituba;2020;23193;11538;11655;99;21137;2056;91.14;3553807
Taquarituba;2021;23246;11564;11682;98.99;21250;1996;91.41;3553807
Taquarivaí;2019;5684;2836;2848;99.58;3281;2403;57.72;3553856
Taquarivaí;2020;5746;2866;2880;99.51;3337;2409;58.08;3553856
Taquarivaí;2021;5803;2894;2909;99.48;3390;2413;58.42;3553856
Tarabai;2019;7202;3569;3633;98.24;6762;440;93.89;3553906
Tarabai;2020;7269;3601;3668;98.17;6834;435;94.02;3553906
Tarabai;2021;7327;3629;3698;98.13;6898;429;94.14;3553906
Tarumã;2019;14615;7422;7193;103.18;13903;712;95.13;3553955
Tarumã;2020;14806;7514;7292;103.04;14093;713;95.18;3553955
Tarumã;2021;14951;7584;7367;102.95;14237;714;95.22;3553955
Tatuí;2019;118833;58554;60279;97.14;115285;3548;97.01;3554003
Tatuí;2020;120123;59175;60948;97.09;116699;3424;97.15;3554003
Tatuí;2021;121202;59697;61505;97.06;117899;3303;97.27;3554003
Taubaté;2019;304596;149184;155412;95.99;298383;6213;97.96;3554102
Taubaté;2020;307361;150507;156854;95.95;301096;6265;97.96;3554102
Taubaté;2021;309483;151515;157968;95.91;303179;6304;97.96;3554102
Tejupá;2019;4702;2390;2312;103.37;3548;1154;75.46;3554201
Tejupá;2020;4697;2385;2312;103.16;3593;1104;76.5;3554201
Tejupá;2021;4707;2387;2320;102.89;3647;1060;77.48;3554201
Teodoro Sampaio;2019;22316;11037;11279;97.85;18420;3896;82.54;3554300
Teodoro Sampaio;2020;22414;11076;11338;97.69;18533;3881;82.68;3554300
Teodoro Sampaio;2021;22495;11109;11386;97.57;18632;3863;82.83;3554300
Terra Roxa;2019;9060;4561;4499;101.38;8714;346;96.18;3554409
Terra Roxa;2020;9121;4589;4532;101.26;8779;342;96.25;3554409
Terra Roxa;2021;9170;4611;4559;101.14;8831;339;96.3;3554409
Tietê;2019;40656;20107;20549;97.85;37129;3527;91.32;3554508
Tietê;2020;41073;20308;20765;97.8;37528;3545;91.37;3554508
Tietê;2021;41405;20466;20939;97.74;37850;3555;91.41;3554508
Timburi;2019;2565;1314;1251;105.04;1990;575;77.58;3554607
Timburi;2020;2557;1309;1248;104.89;1996;561;78.06;3554607
Timburi;2021;2551;1305;1246;104.74;2003;548;78.52;3554607
Torre de Pedra;2019;2313;1204;1109;108.57;1633;680;70.6;3554656
Torre de Pedra;2020;2320;1206;1114;108.26;1651;669;71.16;3554656
Torre de Pedra;2021;2325;1208;1117;108.15;1668;657;71.74;3554656
Torrinha;2019;9675;4833;4842;99.81;8429;1246;87.12;3554706
Torrinha;2020;9713;4847;4866;99.61;8482;1231;87.33;3554706
Torrinha;2021;9736;4854;4882;99.43;8522;1214;87.53;3554706
Trabiju;2019;1686;834;852;97.89;1577;109;93.53;3554755
Trabiju;2020;1703;841;862;97.56;1595;108;93.66;3554755
Trabiju;2021;1716;847;869;97.47;1610;106;93.82;3554755
Tremembé;2019;45519;23667;21852;108.31;42232;3287;92.78;3554805
Tremembé;2020;45978;23882;22096;108.08;42766;3212;93.01;3554805
Tremembé;2021;46364;24064;22300;107.91;43230;3134;93.24;3554805
Três Fronteiras;2019;5536;2754;2782;98.99;4882;654;88.19;3554904
Três Fronteiras;2020;5547;2758;2789;98.89;4908;639;88.48;3554904
Três Fronteiras;2021;5550;2757;2793;98.71;4926;624;88.76;3554904
Tuiuti;2019;6499;3271;3228;101.33;3501;2998;53.87;3554953
Tuiuti;2020;6557;3296;3261;101.07;3560;2997;54.29;3554953
Tuiuti;2021;6597;3313;3284;100.88;3610;2987;54.72;3554953
Tupã;2019;62897;30339;32558;93.18;60374;2523;95.99;3555000
Tupã;2020;62843;30304;32539;93.13;60322;2521;95.99;3555000
Tupã;2021;62720;30242;32478;93.12;60204;2516;95.99;3555000
Tupi Paulista;2019;14851;7677;7174;107.01;11663;3188;78.53;3555109
Tupi Paulista;2020;14878;7686;7192;106.87;11685;3193;78.54;3555109
Tupi Paulista;2021;14877;7682;7195;106.77;11683;3194;78.53;3555109
Turiúba;2019;1915;981;934;105.03;1615;300;84.33;3555208
Turiúba;2020;1912;979;933;104.93;1618;294;84.62;3555208
Turiúba;2021;1905;975;930;104.84;1617;288;84.88;3555208
Turmalina;2019;1821;891;930;95.81;1376;445;75.56;3555307
Turmalina;2020;1805;882;923;95.56;1373;432;76.07;3555307
Turmalina;2021;1789;874;915;95.52;1368;421;76.47;3555307
Ubarana;2019;5989;3040;2949;103.09;5532;457;92.37;3555356
Ubarana;2020;6066;3075;2991;102.81;5608;458;92.45;3555356
Ubarana;2021;6126;3102;3024;102.58;5667;459;92.51;3555356
Ubatuba;2019;87887;43380;44507;97.47;85832;2055;97.66;3555406
Ubatuba;2020;88916;43854;45062;97.32;86842;2074;97.67;3555406
Ubatuba;2021;89782;44249;45533;97.18;87694;2088;97.67;3555406
Ubirajara;2019;4640;2386;2254;105.86;3418;1222;73.66;3555505
Ubirajara;2020;4663;2397;2266;105.78;3439;1224;73.75;3555505
Ubirajara;2021;4684;2407;2277;105.71;3458;1226;73.83;3555505
Uchoa;2019;9664;4775;4889;97.67;9061;603;93.76;3555604
Uchoa;2020;9683;4781;4902;97.53;9082;601;93.79;3555604
Uchoa;2021;9689;4781;4908;97.41;9090;599;93.82;3555604
União Paulista;2019;1725;892;833;107.08;1381;344;80.06;3555703
União Paulista;2020;1739;899;840;107.02;1399;340;80.45;3555703
União Paulista;2021;1751;905;846;106.97;1414;337;80.75;3555703
Urânia;2019;8636;4273;4363;97.94;7504;1132;86.89;3555802
Urânia;2020;8611;4259;4352;97.86;7504;1107;87.14;3555802
Urânia;2021;8584;4245;4339;97.83;7502;1082;87.4;3555802
Uru;2019;1211;614;597;102.85;1130;81;93.31;3555901
Uru;2020;1207;611;596;102.52;1132;75;93.79;3555901
Uru;2021;1203;609;594;102.53;1134;69;94.26;3555901
Urupês;2019;13122;6482;6640;97.62;12027;1095;91.66;3556008
Urupês;2020;13164;6498;6666;97.48;12090;1074;91.84;3556008
Urupês;2021;13181;6503;6678;97.38;12129;1052;92.02;3556008
Valentim Gentil;2019;12601;6301;6300;100.02;11689;912;92.76;3556107
Valentim Gentil;2020;12770;6382;6388;99.91;11859;911;92.87;3556107
Valentim Gentil;2021;12897;6442;6455;99.8;11989;908;92.96;3556107
Valinhos;2019;123268;60596;62672;96.69;117825;5443;95.58;3556206
Valinhos;2020;124742;61300;63442;96.62;119288;5454;95.63;3556206
Valinhos;2021;125800;61798;64002;96.56;120354;5446;95.67;3556206
Valparaíso;2019;23849;12987;10862;119.56;23191;658;97.24;3556305
Valparaíso;2020;23988;13051;10937;119.33;23353;635;97.35;3556305
Valparaíso;2021;24099;13102;10997;119.14;23484;615;97.45;3556305
Vargem;2019;9881;5014;4867;103.02;6095;3786;61.68;3556354
Vargem;2020;10000;5068;4932;102.76;6290;3710;62.9;3556354
Vargem;2021;10094;5110;4984;102.53;6469;3625;64.09;3556354
Vargem Grande do Sul;2019;41287;20398;20889;97.65;39684;1603;96.12;3556404
Vargem Grande do Sul;2020;41501;20494;21007;97.56;39933;1568;96.22;3556404
Vargem Grande do Sul;2021;41684;20576;21108;97.48;40150;1534;96.32;3556404
Vargem Grande Paulista;2019;51770;25624;26146;98;51770;;100;3556453
Vargem Grande Paulista;2020;52762;26108;26654;97.95;52762;;100;3556453
Vargem Grande Paulista;2021;53613;26524;27089;97.91;53613;;100;3556453
Várzea Paulista;2019;119272;59257;60015;98.74;119272;;100;3556503
Várzea Paulista;2020;120535;59859;60676;98.65;120535;;100;3556503
Várzea Paulista;2021;121482;60301;61181;98.56;121482;;100;3556503
Vera Cruz;2019;10544;5158;5386;95.77;9452;1092;89.64;3556602
Vera Cruz;2020;10524;5146;5378;95.69;9460;1064;89.89;3556602
Vera Cruz;2021;10506;5135;5371;95.61;9469;1037;90.13;3556602
Vinhedo;2019;76178;37587;38591;97.4;73784;2394;96.86;3556701
Vinhedo;2020;77521;38238;39283;97.34;75085;2436;96.86;3556701
Vinhedo;2021;78440;38678;39762;97.27;75975;2465;96.86;3556701
Viradouro;2019;18247;9146;9101;100.49;17713;534;97.07;3556800
Viradouro;2020;18347;9192;9155;100.4;17810;537;97.07;3556800
Viradouro;2021;18421;9224;9197;100.29;17882;539;97.07;3556800
Vista Alegre do Alto;2019;7907;4036;3871;104.26;7479;428;94.59;3556909
Vista Alegre do Alto;2020;8014;4087;3927;104.07;7594;420;94.76;3556909
Vista Alegre do Alto;2021;8091;4122;3969;103.85;7680;411;94.92;3556909
Vitória Brasil;2019;1759;891;868;102.65;1554;205;88.35;3556958
Vitória Brasil;2020;1760;890;870;102.3;1562;198;88.75;3556958
Vitória Brasil;2021;1761;890;871;102.18;1570;191;89.15;3556958
Votorantim;2019;118727;58777;59950;98.04;114199;4528;96.19;3557006
Votorantim;2020;119824;59303;60521;97.99;115254;4570;96.19;3557006
Votorantim;2021;120662;59700;60962;97.93;116060;4602;96.19;3557006
Votuporanga;2019;91094;44348;46746;94.87;88542;2552;97.2;3557105
Votuporanga;2020;91760;44664;47096;94.84;89189;2571;97.2;3557105
Votuporanga;2021;92193;44871;47322;94.82;89610;2583;97.2;3557105
Zacarias;2019;2539;1262;1277;98.83;2152;387;84.76;3557154
Zacarias;2020;2560;1271;1289;98.6;2183;377;85.27;3557154
Zacarias;2021;2574;1277;1297;98.46;2208;366;85.78;3557154
